chr,start,start_snpid,end,end_snpid,mex,nsnp,dis
1,325012,PZE-101000161,1003413,SYN8296,0.438913043478261,14,678401
1,1957167,SYN10558,2210506,SYN6001,1.31423913043478,14,253339
1,2538655,PUT-163a-5499487-2275,2716163,SYN38926,0.409788819875774,7,177508
1,3078140,SYN11122,3078783,SYN11127,1.15576086956522,2,643
1,3278670,PZE-101002919,3407925,SYN9368,1.88732274247492,13,129255
1,3708114,SYN11494,3733167,PZA02129.1,0.880282608695655,8,25053
1,3882714,PZE-101004387,3889632,SYN15069,0.38045652173913,2,6918
1,4758551,PUT-163a-50325923-2183,4758589,PUT-163a-50325923-2184,0.85066304347826,2,38
1,4862689,PZD00021.2,4994459,SYN11315,1.98354347826087,8,131770
1,5326925,SYN36149,5338021,SYN36146,0.20680434782609,6,11096
1,5540876,PZE-101008685,5653264,PZE-101009163,0.720358695652175,2,112388
1,5748338,PZE-101009312,5954473,PZE-101009670,0.32784782608696,4,206135
1,6220407,SYN6318,6236377,SYN6337,0.37368260869565,5,15970
1,8351500,SYN35551,8355740,SYN35543,1.08665217391304,5,4240
1,9052575,PZA00447.5,9060038,SYNGENTA14387,0.792473913043478,5,7463
1,9358866,SYN21172,9359168,SYN21175,0.361521739130435,4,302
1,9433811,SYN14142,9435106,SYN14138,0.35847826086957,7,1295
1,9989779,SYN5905,10096325,PZA00106.9,0.668913043478259,9,106546
1,10868783,PZE-101018702,11114825,PZE-101019350,0.623229468599034,9,246042
1,11911814,SYN20883,11952202,SYN20881,0.350471014492753,3,40388
1,12189001,SYN33821,12189099,SYN33825,0.48013043478261,2,98
1,12979261,SYN12547,13539363,SYN20039,0.32048447204969,7,560102
1,14507453,PZE-101024424,14959203,PZA01652.1,0.658456521739127,23,451750
1,15785176,SYN5066,15808888,PZE-101026314,0.39,2,23712
1,16579851,SYN14297,16784593,PUT-163a-71311320-3110,1.88272554347826,8,204742
1,17409398,PZE-101028839,17666998,PZB00718.5,0.46471304347826,5,257600
1,18980563,PZA00358.12,18986228,PZE-101030925,0.338804347826088,3,5665
1,19699766,PZE-101032246,19699932,PZE-101032249,0.386478260869565,2,166
1,20419410,SYN24828,21682502,PZE-101033613,0.921049689440998,28,1263092
1,23243643,SYNGENTA17578,23246099,SYN13195,0.380949275362317,3,2456
1,23610626,PZE-101036305,23618315,PZE-101036338,0.48321739130435,5,7689
1,24308521,SYN7039,24408873,PZE-101037142,0.23483695652174,2,100352
1,25371750,PZE-101038058,25400235,PZE-101038315,0.567489130434783,8,28485
1,26683529,PZE-101039400,26948708,PZE-101039655,0.332347826086956,9,265179
1,27379439,PZE-101040594,27502892,PZE-101040677,1.71135714285714,14,123453
1,27804092,PZE-101041178,27909410,SYN24633,0.66484782608696,2,105318
1,28632923,PZE-101042039,28927650,PZE-101042341,0.345586956521739,8,294727
1,29550398,PZE-101043507,29757662,PZE-101043674,0.76231884057971,6,207264
1,30568749,PZE-101044686,31243619,SYN5392,1.54671739130435,29,674870
1,37776401,PZE-101053715,38010873,PZE-101053822,0.717981884057971,6,234472
1,38871055,SYN23289,38879590,SYN23288,0.55010869565217,3,8535
1,39116930,PZE-101055223,39142562,PZE-101055327,0.859034782608694,5,25632
1,40355622,SYN9128,40511560,PZE-101057000,0.218132850241547,9,155938
1,41469604,SYN29246,41964321,PZE-101058210,0.848790969899666,13,494717
1,42846502,SYN20757,43503480,SYN20593,1.24120380434783,32,656978
1,45004949,PZE-101061114,45115245,PZE-101061225,0.533384057971013,3,110296
1,46684873,PZE-101063527,46685564,PZE-101063539,0.256228260869565,2,691
1,47826025,PZE-101064790,47829728,PZE-101064766,0.648467391304345,2,3703
1,47989070,PZE-101064883,47993084,ZM013299-0478,0.369347826086957,3,4014
1,48505237,PZE-101065086,48547575,PZE-101065262,0.637266304347827,4,42338
1,51017284,ZM003329-0547,52090407,PZE-101068745,1.01110964083176,23,1073123
1,53174005,SYN3086,53422803,PZE-101070910,0.788450000000004,10,248798
1,53666269,PZE-101071282,53850163,PZE-101071373,0.64777391304348,5,183894
1,54186778,PZE-101071660,54603955,PZE-101072150,0.493650895140665,17,417177
1,55575435,PZE-101073032,55759948,PZE-101073078,0.38615217391304,2,184513
1,56221127,SYNGENTA15549,56225853,PZE-101073495,0.503703804347826,8,4726
1,56561450,PUT-163a-60351083-2647,56573528,SYN11005,0.446891304347824,5,12078
1,56892934,SYN37939,57349551,PZE-101074451,1.61429644268774,11,456617
1,57892223,PZE-101074651,58448040,PZE-101074929,1.15955335968379,11,555817
1,58452924,SYN25744,59507482,SYN25503,0.26858695652174,24,1054558
1,59766473,SYN25803,60148639,SYN15501,0.79439130434783,11,382166
1,62530745,SYN29228,62676291,SYN3529,0.21765217391304,3,145546
1,67258256,PZE-101082238,67533887,SYN11221,0.301173913043478,6,275631
1,68670617,SYN25793,69290260,PZE-101081863,0.38389130434783,21,619643
1,69838355,PZE-101082552,69889217,SYN35770,1.82771376811594,6,50862
1,70715868,PZE-101083051,72012732,PZE-101083913,0.60436956521739,26,1296864
1,72618185,PZE-101084186,72820226,PZE-101084361,0.275884057971017,6,202041
1,77146116,PZE-101086823,78988545,PZE-101087816,0.721058876811593,24,1842429
1,79715085,PZE-101088158,80663599,SYN6999,0.22165217391304,26,948514
1,81106413,SYN35629,81603669,SYN23174,0.558984472049693,7,497256
1,82510318,PZE-101090700,82580352,PZE-101090734,0.3559347826087,7,70034
1,84738135,PZE-101092276,84924114,PZE-101092483,0.544149068322981,7,185979
1,85716952,PZE-101093040,85835088,PZE-101093125,1.6040652173913,8,118136
1,86844203,PZE-101093764,87162735,PZE-101093863,0.779114130434785,4,318532
1,87981466,PZE-101097131,88014649,PZE-101097273,0.754715415019763,11,33183
1,88711777,PZE-101097716,90230085,PZE-101098774,1.57426832298137,35,1518308
1,91483978,PZE-101099549,91504795,PZE-101099581,0.631257246376813,6,20817
1,92218585,PZE-101094237,92246832,PZE-101094280,1.51313478260869,5,28247
1,92756783,PZE-101094707,93071406,PZE-101095031,0.762160079051383,11,314623
1,96081157,PZE-101100007,96623344,SYN5444,0.360956521739129,9,542187
1,97881742,PZE-101101031,98353328,PZE-101101316,0.234513833992095,11,471586
1,99664165,PZE-101101856,101780967,PZE-101102740,0.883214209968187,41,2116802
1,105679855,PZE-101104474,105818604,PZE-101104606,1.32312055335968,11,138749
1,116015358,PZE-101108723,116086290,PZE-101108865,0.227876811594203,9,70932
1,116767275,PZE-101109208,123759713,PZE-101112422,0.76710628019324,99,6992438
1,124138960,PZE-101112569,141534136,PZE-101117162,0.53346782608696,100,17395176
1,150682455,PZA03028.5,152089799,PZE-101122461,0.747537625418059,26,1407344
1,154153417,PZE-101123156,155004012,PZE-101123702,1.42815217391304,22,850595
1,155675478,SYN25353,156217012,PZE-101124424,0.354567632850242,9,541534
1,156960729,PZE-101124687,156997164,PZE-101124718,0.286184782608696,2,36435
1,159545297,PZE-101126132,160223650,PZE-101126489,0.58801690821256,9,678353
1,162427809,PZE-101127891,164556608,PZE-101129057,1.03980611045829,37,2128799
1,165405751,PZE-101129562,165408568,SYN29501,0.588826086956522,9,2817
1,170475870,PZE-101132120,170825358,PZE-101132569,0.21504347826087,13,349488
1,171939201,PZE-101132945,172021749,SYN25650,0.302184782608695,2,82548
1,172190334,SYN11483,172284467,PZE-101133216,0.495529891304351,8,94133
1,172940370,PZE-101133677,172947588,PZE-101133702,0.36979347826087,2,7218
1,173227101,PZE-101133891,173661199,SYN38863,0.541630434782613,10,434098
1,173992552,PZB00963.2,175292737,PZE-101135508,0.667682744565217,32,1300185
1,177685787,PZE-101137444,177685868,PZE-101137446,0.401782608695652,2,81
1,179342985,PZE-101138210,179884817,PZE-101139056,0.491960869565217,15,541832
1,180612182,PZE-101139847,180693924,PZE-101139993,1.96227717391304,4,81742
1,182289606,PZE-101141173,182294697,PZE-101141233,0.31355797101449,3,5091
1,183842089,SYN1742,184615641,PZE-101143236,0.216217391304348,16,773552
1,184700424,SYN3632,187193883,SYN3027,0.95917391304348,12,2493459
1,188015481,PZE-101144838,188083114,PUT-163a-13178383-177,0.848847826086957,7,67633
1,189585717,SYN28098,189641815,PZE-101146530,0.653569169960475,11,56098
1,190998267,SYN29733,191091858,SYN14208,0.299577294685993,9,93591
1,193247066,PZE-101149664,193321851,SYN35986,0.85019254658385,7,74785
1,193591740,PZE-101149961,193877500,PZE-101150277,0.39941304347826,12,285760
1,194455064,PZE-101150477,194674422,PZE-101150835,1.12307763975155,7,219358
1,195484495,PZE-101152052,195770152,PZE-101152364,0.734778985507247,12,285657
1,197858175,PZE-101154881,198192767,PZE-101154963,0.24728260869565,3,334592
1,198653310,PZE-101155676,198655438,PZE-101155685,0.711101449275363,3,2128
1,199726769,PZE-101157104,199741912,SYN26142,0.620677536231885,6,15143
1,199871129,SYN21424,199963599,PZE-101157488,1.06561956521739,2,92470
1,201868530,PZE-101159556,201872641,SYN38894,0.552681159420293,3,4111
1,202160819,PZE-101159840,202169254,PZE-101159930,0.26742028985507,3,8435
1,202919228,PZE-100001836,202998070,PZE-100001904,0.48660144927536,3,78842
1,203647359,PZE-101160941,204064104,PZE-101161396,0.512369565217388,4,416745
1,205186159,SYN34867,205412626,SYN10829,1.14797826086957,12,226467
1,205533776,PZE-101162348,205558576,PZE-101162356,0.48573913043478,2,24800
1,206124271,SYN14326,206266073,SYN20516,0.38373913043478,4,141802
1,206459390,PZE-101163181,206514625,PZE-101163301,2.5814347826087,3,55235
1,207127152,SYN21493,207372264,PZE-101164129,0.267515527950311,7,245112
1,207600263,PZE-101164344,207611833,PZE-101164389,0.338608695652174,4,11570
1,209182100,PZE-101166237,210408104,SYN14508,0.850361556064074,19,1226004
1,210707697,PZE-101167437,210789703,SYN28182,0.317427536231883,3,82006
1,210996629,PZE-101167577,211257338,PZE-101167756,0.385655279503106,7,260709
1,212059932,PZE-101168807,212532252,PZE-101169204,1.6005995423341,19,472320
1,212951968,PZE-101169429,213096535,PZE-101169609,1.1396149068323,14,144567
1,216695411,SYN28640,217181526,SYN17605,0.239,12,486115
1,217450963,PZE-101173784,217617575,PZE-101173929,0.692703804347826,8,166612
1,218800974,SYN31725,220828000,PZE-101176290,0.288349700149928,58,2027026
1,221369064,PZE-101176624,221785673,PZE-101176905,1.06859782608696,12,416609
1,222446833,SYN13006,222979756,PZE-101178021,0.511501086956522,20,532923
1,223319103,PZE-101178330,223400905,PZE-101178225,1.30085869565217,4,81802
1,225033350,PZB01979.2,225138023,PZE-101180929,0.56924901185771,11,104673
1,225482940,ZM006619-0620,225504214,PZE-101181049,0.806395652173916,5,21274
1,225866807,PZE-101181384,225883687,PZE-101181505,0.806402173913045,2,16880
1,228151671,SYN18165,228252624,SYN12952,0.279282608695652,6,100953
1,230717634,PZE-101185989,230720425,PZE-101186005,0.542108695652177,3,2791
1,230959029,PZE-101186536,232310757,PZE-101187227,0.32449604743083,22,1351728
1,232520712,SYN27669,232742916,PZE-101187743,0.278123641304348,16,222204
1,234900313,SYN3317,234941804,PZE-101189338,0.483123188405793,3,41491
1,235833955,PZE-101190026,235864222,PZE-101190037,1.40630434782609,2,30267
1,236915800,PZE-101190721,236953405,PZE-101190832,0.32965217391304,6,37605
1,237087198,PZE-101190927,237608710,PZE-101191386,0.38184510869565,8,521512
1,238750301,PZE-101192259,238752707,PZE-101192304,1.41343478260869,3,2406
1,239616009,PZE-101192859,240282219,PZE-101193425,0.581382608695651,15,666210
1,244071105,PZE-101196188,244157530,PZE-101196242,0.39432608695652,3,86425
1,244469276,PZE-101196421,244756064,PZE-101196704,0.454406521739132,10,286788
1,246811542,PZE-101198633,246820584,PZE-101198659,0.319065217391304,6,9042
1,247614969,PZE-101198839,248737375,PZE-101199598,0.655679347826087,24,1122406
1,251386221,SYN28220,251711469,PZE-101201972,0.315439130434784,5,325248
1,251986395,PZE-101201778,251995695,PZE-101201666,0.35284239130435,4,9300
1,253493820,PZE-101204633,253715394,PZE-101204975,0.304059006211181,7,221574
1,254094758,PUT-163a-148951459-517,254263888,PZE-101205609,0.548961956521739,8,169130
1,254534247,PZE-101205743,256466361,PZE-101207044,0.982928471248249,31,1932114
1,256515262,SYN32084,256797371,PZE-101207480,0.669670807453417,7,282109
1,257206089,PZE-101207892,257326157,SYN14563,0.282978260869567,3,120068
1,257458841,PZE-101208112,257974957,PZE-101208406,0.283204347826086,15,516116
1,259272600,PZE-101209983,259408630,PZE-101210179,1.18674456521739,12,136030
1,260520076,SYN25458,260684675,SYN15085,0.797630434782609,7,164599
1,260920359,SYN2267,262720351,PZA00709.19,1.12797554347826,40,1799992
1,263732110,PZE-101213494,263740719,PZE-101213558,0.380818840579713,3,8609
1,264094317,PZE-101213680,264167330,PZE-101213738,0.775633540372671,7,73013
1,265652447,PZD00084.2,266048142,PZE-101215416,0.380190711462451,22,395695
1,266094940,PZE-101215449,266095836,PZD00066.3,0.324097826086955,2,896
1,269218944,PZE-101218080,269353952,SYN25903,1.03151207729469,9,135008
1,270126883,PZE-101218835,270409892,PZE-101218966,0.598146376811593,15,283009
1,271025986,PZE-101219633,271126791,PZE-101219724,0.768461956521738,4,100805
1,271627282,PZE-101220098,271762969,PZE-101220221,0.670753623188403,3,135687
1,273675847,PZE-101222398,273693583,PZE-101222445,0.598526086956522,5,17736
1,274531710,SYN30528,275780292,PZE-101225496,1.28653859804792,49,1248582
1,276307975,SYN16701,276816355,PZE-101226725,0.723118577075099,22,508380
1,277849479,PUT-163a-93011727-4797,278607249,PZE-101228874,0.928207298136642,28,757770
1,279571516,SYN2725,279576503,SYN2728,0.24478260869565,6,4987
1,280218373,SYN27285,280342748,PZE-101231477,0.84217391304348,3,124375
1,280975319,SYN25211,281071509,SYN32976,1.13060869565217,6,96190
1,281334529,PZE-101233231,281516184,PZE-101233287,0.5020597826087,4,181655
1,281709021,PZA03188.3,281709732,PZE-101233861,1.15668115942029,3,711
1,282468793,SYN10352,282745085,SYN5995,0.530669960474307,11,276292
1,283363772,PZE-101235826,283389692,PZE-101235852,0.63008695652174,2,25920
1,284500666,PZE-101236600,285071669,SYN20058,1.21167984189723,11,571003
1,285640719,PZE-101237912,285782998,SYN443,1.12932608695652,5,142279
1,286326752,SYN32910,286359450,PZB01403.4,0.283478260869568,4,32698
1,286453013,PZE-101239020,286851312,SYN38914,0.445054347826086,16,398299
1,287718234,SYN37684,288394832,PZE-101241535,0.44887101449275,15,676598
1,290449014,PZE-101244291,290555098,SYN19016,0.277202898550727,3,106084
1,291789227,SYN27559,291863331,SYN27560,1.1225652173913,3,74104
1,292134984,SYN3286,292138226,PZE-101246418,0.42978260869565,2,3242
1,292796831,PUT-163a-33467364-2021,292796839,PUT-163a-33467364-2020,0.34545652173913,2,8
1,293519813,PZE-101248317,293628626,SYN38691,0.42526086956522,3,108813
1,293638311,SYN38692,293795952,PZA00235.9,0.4215652173913,4,157641
1,294728560,SYN31870,295067548,SYN16865,0.25252173913043,14,338988
1,295304944,SYN8230,295311591,SYN8237,1.34978260869565,10,6647
1,295762691,PZE-101251114,296003899,SYNGENTA12924,0.402659420289857,9,241208
1,296023133,SYN36179,296658750,SYN27361,0.557989648033127,21,635617
1,298332124,SYNGENTA11155,298879663,SYN16573,0.660178853754943,22,547539
1,298967104,PUT-163a-60399874-3008,298967713,SYN7988,0.57395652173913,3,609
1,299045712,SYN7987,299047644,SYN7985,0.806623188405797,6,1932
1,299122439,SYN38953,299125086,SYN38947,0.356054347826088,4,2647
1,299528185,PZB01937.2,299560371,PUT-163a-78092903-4261,1.6675900621118,7,32186
1,300072663,PZE-101256707,301275802,PZE-101257498,0.48561133069829,33,1203139
2,10232,SYN1722,1288990,SYN6180,1.26109217391304,50,1278758
2,2114624,SYN148,2120469,SYN146,0.48760869565217,6,5845
2,3614453,SYN2670,3614754,SYN2667,0.343536231884057,3,301
2,3735379,PZE-102007366,3739218,SYN9222,0.563826086956522,3,3839
2,4299784,SYN31108,4302909,SYN31118,0.50336956521739,3,3125
2,4365980,PZE-102009755,4371417,PZE-102009795,1.18053260869565,2,5437
2,4699070,SYN3554,4839270,SYN37569,0.82195652173913,6,140200
2,5379183,SYN10374,5379504,SYN10378,0.284983695652173,4,321
2,5459218,PZE-102011930,5506436,PZE-102012134,0.224681159420293,3,47218
2,5818698,SYN29492,5827148,SYN29498,0.983158102766799,11,8450
2,6176216,SYN7225,6474772,SYNGENTA1700,0.346119565217392,16,298556
2,6641268,PUT-163a-148972919-653,6641601,PUT-163a-29946131-1834,0.20128260869565,2,333
2,7950855,PZE-102017798,8293999,PZE-102018085,1.62788819875776,7,343144
2,8781646,PZE-102018300,8873169,SYN12998,0.63967391304348,13,91523
2,8910492,PUT-163a-60342470-2456,8920324,SYN12986,0.26378260869565,5,9832
2,9109659,PZE-102019299,9126561,SYN1141,1.86773913043478,12,16902
2,9985308,SYN11386,9986953,SYN11378,0.462788043478262,4,1645
2,10344138,SYN5848,10386100,SYN38158,1.23115217391304,3,41962
2,10519859,SYN30570,10520160,SYN30586,0.276739130434787,3,301
2,10603658,ZM002926-0696,10607539,SYN27866,0.429490338164251,9,3881
2,11984703,SYN7624,11985661,SYN7635,0.50833152173913,8,958
2,12350353,SYN36013,12352215,ZM013413-0669,0.25078260869565,3,1862
2,13850890,PZE-102029712,13864569,PZE-102029773,0.34349456521739,4,13679
2,14462712,SYN9584,14469306,PZE-102031002,0.30623913043478,2,6594
2,14799999,PZE-102031753,14836855,PZA01753.1,0.444778985507245,6,36856
2,15242742,PZE-102032511,15273241,SYN3312,0.483799999999996,5,30499
2,15892733,SYN14434,15995850,SYN7467,0.786229619565218,16,103117
2,17091639,PZE-102035948,17100186,PZE-102036006,0.995396739130435,4,8547
2,17435873,PZE-102036373,17544233,PZE-102036427,0.25284782608696,4,108360
2,18618444,PZE-102038457,18643963,PZE-102038582,0.579514492753622,6,25519
2,19254164,PZE-102039123,19282682,PZE-102039358,0.63078695652174,5,28518
2,19432056,PZE-102039583,19989478,PZE-102039927,2.13145652173913,10,557422
2,20536744,SYN9105,20793481,SYN30697,0.618171014492754,15,256737
2,23473079,PZE-102045516,24033371,PZE-102046696,0.664582298136646,14,560292
2,24558980,PZE-102046980,24559934,PZE-102046998,0.41671739130435,3,954
2,25304287,PZE-102047551,25310110,PZA-001755001,0.353902173913045,2,5823
2,25733764,PZE-102047663,26849841,SYN700,0.753937888198758,35,1116077
2,27052498,PZE-102048896,27053394,PZE-102048901,0.47514130434783,2,896
2,27482375,PZB02035.2,27482479,PZB02035.3,0.21497826086957,2,104
2,28309765,PZE-102050587,28563961,PZE-102050786,0.34141304347826,10,254196
2,28703513,SYN3933,29041311,PZE-102051452,1.23527445652174,8,337798
2,29227238,PZE-102051839,29524205,PZE-102052096,0.819482608695652,5,296967
2,32259201,SYN9760,33006611,PZE-102054921,0.694053511705686,13,747410
2,33464342,SYN2281,33765568,PZE-102056209,0.379787723785164,17,301226
2,34688541,PZE-102056752,34699461,PZE-102056713,0.226358695652175,4,10920
2,35271564,PZE-102056984,35272010,SYN5394,0.308141304347826,2,446
2,35319494,PZE-102057024,35483048,PZE-102057220,0.483300000000001,5,163554
2,36586856,SYN34242,36605493,SYN34227,0.556108695652175,10,18637
2,37046358,PZE-102058916,37051147,PZE-102058956,0.335641304347825,2,4789
2,41007815,SYN5860,41010158,PZE-102062629,0.24426086956522,3,2343
2,41300032,PZE-102062967,41775521,PZE-102063606,0.735015345268542,17,475489
2,42791912,PZA00226.6,43203856,PZE-102065188,0.758951086956523,12,411944
2,47364330,PZE-102069361,47365562,PZE-102069392,0.83357608695652,2,1232
2,48108026,PZE-102069907,48108160,PZE-102069908,1.05363043478261,2,134
2,48588699,PZE-102070420,48738479,PZE-102070496,1.22042857142857,14,149780
2,48928593,PZE-102070724,49729138,PZA03489.1,1.21284782608696,17,800545
2,51280136,SYN38709,52318107,SYN394,0.793536684782606,32,1037971
2,54926708,PZE-102074320,54968268,SYN23126,0.512817391304348,5,41560
2,55679576,SYN36680,55829631,PZE-102075412,1.50797204968944,7,150055
2,58763445,PZE-102076842,58766265,PZE-102076876,0.222423913043475,2,2820
2,59357377,PZE-102077123,60276380,PZE-102077620,1.49080837359098,27,919003
2,60656421,PZE-102077877,60665495,PZE-102077906,0.4285,2,9074
2,60874421,PZE-102078110,60875051,PZE-102078126,0.32532608695652,2,630
2,63372339,PZE-102079950,63944471,SYN14496,0.788429951690822,18,572132
2,63949812,PZE-102080336,64393073,PZE-102080632,1.16608074534161,14,443261
2,67149723,PZE-102081812,67542661,PZE-102081964,0.258256038647343,9,392938
2,69180126,PZE-102082911,80331730,PZE-102087084,1.28483920229968,121,11151604
2,85477179,PZE-103095150,104205558,PZE-102093254,0.957432787229576,207,18728379
2,107189348,PZE-102094213,109545781,PZE-102095556,0.31228260869565,33,2356433
2,118450007,PZE-102099996,118450115,PZE-102099997,0.31378260869565,2,108
2,118981561,PZE-102100180,120283817,PZE-102100681,2.78067391304348,13,1302256
2,120436565,PZE-102100760,126983509,PZE-102103212,2.13063111413044,96,6546944
2,127959743,PZE-102103687,131559285,PZE-102105456,1.15773217391304,75,3599542
2,134611189,PZE-102106504,140973183,PZE-102109589,0.859887826086952,75,6361994
2,141363433,PZE-102109721,141561790,PZE-102109861,0.31223913043478,5,198357
2,142532326,PZE-102110255,143431505,PZE-102110850,0.572658514492754,24,899179
2,148878787,SYN22871,149338757,PZE-102113818,0.24386956521739,9,459970
2,149785951,PUT-163a-4226318-2039,150227222,PZE-102114289,1.30413768115942,9,441271
2,151797551,PZE-102115210,153400906,PZE-102115940,0.659440711462449,22,1603355
2,153852007,PZE-102116113,153967493,PZE-102116215,0.337234299516909,9,115486
2,154602241,PZE-102116447,156209861,PZE-102117141,0.575091032608696,32,1607620
2,156726411,PZE-102117310,157358259,PZE-102117605,0.645687747035573,11,631848
2,158408759,PZE-102118282,160262306,PZE-102118927,1.09904347826087,26,1853547
2,160541812,PZE-102118979,165872485,SYN6931,0.739154925701708,79,5330673
2,167247232,PZE-102121475,168555051,PZE-102122092,0.469942455242967,17,1307819
2,170854144,PZE-102123437,170875721,SYN25968,0.329695652173913,3,21577
2,176451542,PUT-163a-71765208-3497,177499135,PZE-102127702,1.23148861283644,42,1047593
2,177647002,PZE-102127751,177874858,SYN33463,0.761173913043481,10,227856
2,180626735,PZE-102130434,180906049,PZE-102130760,0.522108695652175,5,279314
2,181424666,PZE-102131113,181544623,PZE-102131236,1.28674456521739,4,119957
2,182343469,PZE-102131962,182347126,PZE-102132005,1.45074347826087,5,3657
2,183184401,PZE-102132579,183408182,PZE-102132777,0.825859903381643,9,223781
2,184480649,PZE-102134204,184760284,PZE-102134499,0.390618357487924,9,279635
2,185379678,SYN1715,185645193,PZE-102136175,2.63173913043478,13,265515
2,186265441,PZE-102137410,186464021,PZE-102137628,0.369627329192544,7,198580
2,187368128,SYN28324,187881841,PZE-102139754,0.719168896321069,13,513713
2,188415949,SYNGENTA3163,188874833,SYN26577,0.394908695652174,15,458884
2,189224132,PZE-102141929,189275033,SYN7410,0.42154347826087,5,50901
2,189635143,PZE-102142740,189717808,PZE-102142917,0.463326086956522,3,82665
2,189937437,PZE-102143316,190024493,PZE-102143398,0.31346739130435,2,87056
2,190422041,PZE-102143712,190431483,PZE-102143736,0.917358695652175,2,9442
2,192453336,PZE-102145560,192581292,PZE-102145607,0.439157608695653,4,127956
2,193319543,SYNGENTA12112,193650032,PZE-102146567,0.527585812356976,19,330489
2,194037420,PZE-102147036,194043443,PZE-102147076,0.89138043478261,2,6023
2,195175487,PZE-102148412,195176974,PZE-102148410,0.241514492753623,3,1487
2,195714610,PZE-102148907,195716007,PZE-102148914,1.57328260869565,3,1397
2,196222019,SYN15388,196222087,PUT-163a-18163148-1243,0.305,2,68
2,196383782,PZE-102149655,196457774,PZE-102149768,0.354965217391306,5,73992
2,197381535,PZE-102150762,197624296,SYN1761,0.744001976284585,11,242761
2,197832799,PZE-102151305,198019990,SYN192,2.4230579710145,6,187191
2,198435382,SYN21754,198583708,SYN25689,3.493,6,148326
2,198717467,SYN15809,198722781,PZA02017.7,0.55878260869565,4,5314
2,198896536,PZE-102152341,198905161,SYN35301,1.06860869565217,5,8625
2,199653590,PZE-102153188,199668703,PZE-102153217,0.286021739130435,2,15113
2,202158213,SYN588,202311926,SYNGENTA3331,0.44627950310559,7,153713
2,202528563,PZE-102155107,203633237,PUT-163a-149111560-968,0.860594021739132,40,1104674
2,203844850,SYNGENTA11653,203900418,SYN39124,0.600210144927535,3,55568
2,204077837,PZE-102157010,204081371,PZE-102156959,0.95496739130435,2,3534
2,204170506,PZE-102157204,204338784,PZE-102157572,0.529293478260872,4,168278
2,206122992,PZE-102159951,206259739,SYN36741,1.02810869565217,8,136747
2,206629114,SYN29729,207160771,SYN5872,0.393745524296673,17,531657
2,207839969,SYN5620,207841753,PUT-163a-110504512-88,0.549753623188407,3,1784
2,208941503,PZE-102163599,208942469,PZE-102163621,0.538521739130435,2,966
2,209255034,SYN7498,209543656,PZE-102164997,0.206782608695652,10,288622
2,210031577,PZE-102165455,210393174,SYN24422,0.372521739130434,5,361597
2,210529271,ZM013948-0579,210531957,PZE-102166026,0.880445652173915,2,2686
2,210958981,PUT-163a-91055763-4742,211498056,SYN20955,0.732386645962732,14,539075
2,211773129,PZE-102167923,212407099,SYN34317,0.24028260869565,19,633970
2,214661090,PZE-102171277,214666548,SYN27803,0.46432608695652,2,5458
2,217225065,SYN31065,217332336,SYN31462,0.40591304347826,5,107271
2,218463546,SYN179,218465089,SYN178,0.646228260869566,2,1543
2,219661637,PZE-102177071,219728828,PZE-102176993,0.52536956521739,3,67191
2,220764915,PZE-102178194,222163749,SYN21841,0.25717391304348,20,1398834
2,223310722,SYN18301,223888876,SYN8667,0.552874999999999,4,578154
2,225530997,SYN28305,225651826,PZE-102183051,0.216965217391306,5,120829
2,225852525,PZE-102183282,226370656,PZE-102183628,0.73283574879227,9,518131
2,228035636,PZE-102184436,228175265,PZE-102184643,0.430206521739133,10,139629
2,229287540,PZE-102185494,229298876,PZE-102185564,0.239652173913045,2,11336
2,229574239,PZE-102185808,229821605,PZE-102186076,0.45217701863354,7,247366
2,229996082,SYN38986,230520837,SYN39026,0.58127639751553,7,524755
2,230866963,PZE-102186665,230934520,PZA02727.1,1.46234387351779,11,67557
2,231115198,PZE-102187119,231117913,PZE-102187115,1.00478260869566,2,2715
2,231296350,PZE-102187332,231660579,PZE-102187611,0.3415652173913,3,364229
2,232965098,PZE-102189370,233113914,PZE-102189702,0.34995,10,148816
2,233908519,SYN37311,234211936,PZA02170.1,0.728138586956524,8,303417
2,234718008,PZE-102192366,234723523,SYN6446,0.389649068322982,7,5515
2,235768324,PUT-163a-110194326-44,235783831,PZE-102193286,0.5635,4,15507
3,1535911,PZE-103000858,1602872,PZE-103001177,0.834311594202897,9,66961
3,2445009,SYN39153,2451412,PZE-103003246,0.456949275362319,9,6403
3,2628040,PZE-103003580,2783611,SYN10209,0.476869565217394,7,155571
3,3107023,SYN34567,3311084,SYN34622,0.65882608695652,8,204061
3,3835786,PZE-103006822,3885697,SYNGENTA13501,3.53104347826087,10,49911
3,4345305,SYNGENTA14279,4444062,PZE-103007776,0.95941304347826,7,98757
3,4679410,SYN5649,4680684,PZE-103008499,0.631210144927536,3,1274
3,4883149,SYN28478,4896318,PZE-103009187,0.930978260869565,9,13169
3,5433765,SYN7900,5584464,SYN31027,0.639421404682278,13,150699
3,5852699,SYNGENTA17024,5948485,PZE-103011490,0.795478260869563,3,95786
3,6796013,PZE-103013156,6802461,PZE-103013135,0.78840217391304,2,6448
3,6937795,PZE-103013339,6955469,PZE-103013405,0.37066304347826,2,17674
3,9044495,SYN13696,9067379,SYN13699,0.2456847826087,2,22884
3,9380181,SYN21250,9432912,SYN31664,0.2655652173913,4,52731
3,10274371,SYN7557,10277935,SYN7564,0.287832298136646,7,3564
3,10453059,SYN24350,10455006,PZE-103017768,0.32,2,1947
3,11446488,PZE-103019236,11649402,SYNGENTA10369,0.582594861660077,11,202914
3,13312272,SYN37725,13504561,PZE-103021381,1.73415217391304,15,192289
3,13686330,PUT-163a-14245173-339,13686484,PUT-163a-13382148-213,0.294293478260865,2,154
3,15056259,PZE-103022830,16309019,PZE-103023739,0.639547101449277,24,1252760
3,17019948,SYN27550,17034287,SYNGENTA10712,0.53704347826087,4,14339
3,18994492,PZE-103025956,18998290,PZE-103026023,0.711873913043476,5,3798
3,19944061,SYN8204,20417709,SYN28131,0.501033248081843,17,473648
3,22385428,PZE-103029873,22389425,PZE-103029988,0.78015760869565,4,3997
3,23011641,SYN555,23100413,PZE-103031099,0.656396739130432,4,88772
3,23209748,PZE-103031307,23263616,PZE-103031363,0.256907608695652,4,53868
3,23435044,PZE-103031418,24906062,PZE-103032194,0.316665056360708,27,1471018
3,26313002,PZE-103033731,26354139,PZE-103033843,0.252876811594207,3,41137
3,29008787,PZE-103035720,30050207,PZE-103036576,0.618942834138485,27,1041420
3,31390797,SYN11138,32125008,SYN6859,0.672067774936065,34,734211
3,35353297,PZE-103039662,35353733,SYN12767,1.05139130434783,3,436
3,37092182,PZE-103041012,37238076,PZE-103041138,0.4302371541502,11,145894
3,38048617,PZE-103041556,38053211,SYNGENTA5939,0.224275362318837,3,4594
3,38602012,PZE-103041877,41403869,PZE-103043110,2.125431575196,61,2801857
3,43092692,PZE-103043712,43524890,PZE-103044113,0.800177018633539,14,432198
3,48043020,SYN13453,48493599,SYN657,0.50741304347826,5,450579
3,49562562,PZE-103047128,52746998,PZE-103048931,0.212782608695651,43,3184436
3,53143525,PZE-103049110,54253578,PZE-103049829,0.932196640316204,22,1110053
3,56813579,PUT-163a-16927508-1172,57393000,PZE-103051733,0.53976811594203,18,579421
3,58079313,PZE-103052016,58559423,PZE-103052358,0.270195652173914,14,480110
3,58714575,PUT-163a-78113073-4314,59044722,PZE-103052720,0.289352842809369,13,330147
3,59601054,PZE-103052979,61242313,PZE-103053867,0.449790081521739,32,1641259
3,62611266,PZE-103054237,66343921,PZE-103055347,1.49977307398932,57,3732655
3,66948452,PZE-103055682,87088829,PZE-103059812,1.81297693328908,131,20140377
3,87544980,PZE-103059944,91088034,PZE-103061139,0.732076339737108,43,3543054
3,96177826,PZE-103062429,98793483,PZE-103063053,0.896703661327231,19,2615657
3,106008242,PZE-103065661,107196502,PZE-103066354,1.78895355731226,22,1188260
3,111448524,PZE-103068050,111448581,PZE-103068051,0.253152173913043,2,57
3,111871873,PZE-103068203,111913098,PZE-103068224,0.666746376811593,3,41225
3,111963472,PZE-103068285,111971131,SYN38653,0.291108695652175,2,7659
3,112027496,PZE-103068422,114790935,PZE-103070324,1.46349914748508,51,2763439
3,115005691,PZE-103070612,118288461,PZE-103071922,0.924504140786754,42,3282770
3,118807567,PZE-103072120,119967521,SYN22862,0.79169565217391,23,1159954
3,119991018,PZE-103072825,121623941,PZE-103073407,1.57490846681923,19,1632923
3,122061563,PZE-103073631,122380917,ZM013111-0295,0.612091032608698,16,319354
3,122383001,PZE-103073940,123405178,PZE-103074652,0.450019323671496,27,1022177
3,126444842,PZE-103076130,127050081,PZE-103076395,0.897239130434783,14,605239
3,127544472,PZE-103076950,128633138,PZE-103077593,0.438715415019763,22,1088666
3,128881344,SYN9672,134791581,SYN8186,1.64828380315337,91,5910237
3,134867390,PZE-103081176,134907654,PZE-103081219,0.3025,2,40264
3,136419047,PZE-103082430,136845464,PZE-103082585,1.31606832298137,7,426417
3,140551607,PZE-103084865,142695512,PUT-163a-16919470-1026,0.701523550724637,48,2143905
3,143801136,ZM013583-0354,143802488,PZE-103086785,2.21861956521739,4,1352
3,144265686,PZE-103087100,144416264,SYN9853,0.40378260869565,4,150578
3,147010907,PZE-103088722,147016645,PZE-103088747,0.75823913043478,4,5738
3,147406521,SYN8458,147938876,SYN8494,1.66769358178054,21,532355
3,152182235,PZE-103092313,152202763,PZB01183.1,0.535115942028986,3,20528
3,153855825,PZE-103092830,154017140,PZE-103093040,0.94172463768116,9,161315
3,156278627,PZE-103096403,156284786,PZE-103096420,0.205597826086955,4,6159
3,156483037,PUT-163a-111190332-143,156485810,PZE-103096619,0.365202898550727,3,2773
3,157050918,PZE-103097469,158444676,PZE-103098174,0.673179130434783,25,1393758
3,158511921,PZE-103098232,158514003,PUT-163a-4174570-2032,0.348983695652174,4,2082
3,158524074,PZE-103098283,158525361,PZE-103098294,0.461586956521739,2,1287
3,158768649,PZE-103098440,158901632,SYN25550,3.05023411371237,13,132983
3,165468730,SYN31292,165477968,SYN31293,0.51595652173913,2,9238
3,165725085,PUT-163a-16925568-1103,165733512,PZE-103104198,0.398543478260871,8,8427
3,166011175,SYN14727,166033152,SYN38962,0.41445652173913,4,21977
3,166448477,PUT-163a-76293601-3974,168525546,PZE-103107609,1.13554199604743,44,2077069
3,169576793,PZE-103108648,169730362,PZE-103108908,0.372304347826086,4,153569
3,170436993,PZE-103109875,170444223,SYN23413,1.15241304347826,4,7230
3,170499681,PZE-103110183,170771737,PZE-103110416,0.637093167701864,7,272056
3,171894961,SYN37786,172050320,PZE-103111690,0.3780652173913,6,155359
3,172675399,PZE-103112970,173005115,SYN28495,0.410274456521736,8,329716
3,175554472,PZE-103115618,175562116,PZE-103115629,1.22972826086957,2,7644
3,176677313,PZE-103118101,176791731,SYN1547,1.89597826086957,6,114418
3,177019447,PZE-103118331,177446587,PZE-103118562,2.17646153846154,13,427140
3,178048578,PZE-103119143,178183413,SYN21417,0.436945652173915,8,134835
3,178411734,PZE-103119878,179126977,PZE-103120779,1.04626086956522,23,715243
3,179969363,SYN8830,179989195,SYN8834,0.510434782608695,2,19832
3,180744946,SYN31730,180747973,PZE-103123019,0.23746739130435,2,3027
3,180899575,PZE-103123171,181124427,PZE-103123538,1.65208212560386,9,224852
3,181652847,ZM013383-0465,181654172,PZA03359.4,0.263728260869565,4,1325
3,181768919,PZE-103124449,181906146,PZE-103124686,0.66313043478261,6,137227
3,183084768,ba1.5,183085021,ba1.7,1.0353768115942,3,253
3,183134322,PZE-103125579,183323668,PZE-103125767,0.230478260869565,9,189346
3,183555110,PZE-103125892,183646238,PZE-103126019,0.342760869565216,5,91128
3,184239673,PZE-103127045,184281956,SYN1223,0.28554347826087,3,42283
3,184434775,SYN1220,184630418,SYN23233,0.745449275362319,6,195643
3,186929492,SYN10950,186929813,SYN10949,0.81428260869565,3,321
3,187028970,SYN36300,187439811,SYN21219,1.20530179028133,17,410841
3,188091257,PZE-103132112,188336432,SYN834,0.803736024844721,14,245175
3,189457886,PZE-103133568,189536582,PZE-103133772,0.42278260869565,2,78696
3,189985384,SYN5521,190062809,PZE-103134460,0.53945652173913,2,77425
3,191925944,SYN23089,193758223,PUT-163a-149109030-949,0.572747035573122,33,1832279
3,195243738,PZE-103138943,195268058,SYN33683,1.13696376811594,3,24320
3,195318901,PZE-103139039,195514372,SYNGENTA14765,0.568809782608697,12,195471
3,196091378,PZE-103140361,196154842,PZE-103140670,0.53659782608696,4,63464
3,196351287,SYN6514,196569483,PZE-103141268,1.54349011857708,11,218196
3,197252279,PZE-103141647,198216282,SYN22986,0.500886287625416,26,964003
3,198520055,PZE-103142979,198600428,PZE-103143078,0.889273913043478,5,80373
3,199244715,PZE-103143599,199248941,PZE-103143669,0.315072463768113,3,4226
3,199274499,PUT-163a-18176904-1455,199561516,SYN33373,1.04683695652174,8,287017
3,199828443,SYN31493,200311070,PZE-103145363,0.732334782608695,10,482627
3,200396129,PZE-103145512,200426061,PZE-103145531,1.50747826086957,3,29932
3,201180601,SYN8109,201249293,PZE-103146632,1.42136956521739,8,68692
3,201301820,PZD00004.3,202184988,PZE-103148276,0.486985507246377,36,883168
3,202763772,PZE-103148725,202768902,PZE-103148803,0.45196195652174,4,5130
3,202829563,SYN28290,202830926,PZE-103148913,0.219065217391303,3,1363
3,203465196,PZE-103149456,203895038,PZE-103149689,0.823669960474311,11,429842
3,204283178,PZE-103150004,204286171,PZE-103150034,1.12186956521739,2,2993
3,204994023,PZE-103151010,205025245,SYN18656,0.37993115942029,6,31222
3,205407552,PUT-163a-148964486-613,206617131,PZE-103153359,1.40415879017014,23,1209579
3,207413237,PZE-103154516,207555271,PZE-103154688,0.516907608695653,12,142034
3,209735048,SYN34625,209913159,SYN36311,1.52855797101449,12,178111
3,210267125,SYN20828,210508497,SYN32112,0.33891304347826,14,241372
3,213800881,SYN36395,214208285,PZE-103164338,1.36784782608696,5,407404
3,214305947,SYN35424,214795607,PZE-103165058,0.635763586956523,8,489660
3,214899677,SYN36904,214900353,SYN36909,2.85754347826087,4,676
3,215181142,PHM13742.5,215218459,PZE-103165871,0.48313043478261,2,37317
3,215850087,PZA03146.2,215902752,PZE-103166909,0.52184782608696,4,52665
3,216008196,PUT-163a-22545298-1589,216477504,PZE-103167850,0.37878260869565,19,469308
3,217571921,SYN31519,217631510,SYN31517,0.27480434782609,3,59589
3,217895507,SYN6785,217899034,SYN6765,0.99939130434783,5,3527
3,219834845,PUT-163a-71331763-3192,220028220,PZE-103173540,1.35429710144928,9,193375
3,220506868,PUT-163a-78087967-4211,220686743,PZE-103174030,0.391665217391303,10,179875
3,221688583,PZE-103175779,221705978,PZE-103175946,0.404614130434785,4,17395
3,221923815,PZE-103176167,222451007,PZE-103176477,0.572630434782609,5,527192
3,223083077,PZE-103177259,223090872,SYN24268,1.8856847826087,4,7795
3,223561082,PZE-103177674,223683787,PZE-103177781,0.262567934782611,8,122705
3,223737353,ZM014594-0272,223752352,PZE-103177974,0.750821739130436,5,14999
3,224487247,PZE-103179078,224631614,SYN4283,0.469913043478261,11,144367
3,225037917,ZM003376-0242,225341156,SYN617,0.894608695652174,13,303239
3,225579187,PZE-103180685,225823377,SYNGENTA11784,0.662534782608694,10,244190
3,226957117,SYN29677,226957202,PZE-103181990,0.26897826086957,2,85
3,227128965,PZE-103182399,227129108,PZE-103182400,0.956260869565217,2,143
3,227274031,PZE-103182712,227413494,PZE-103182953,0.449285326086959,8,139463
3,227486499,PZE-103183147,227624308,PZE-103183235,2.53652173913043,5,137809
3,228451330,PZE-103183786,228451397,PZE-103183787,0.86534782608696,2,67
3,229241840,SYN4876,229385474,PZE-103184603,0.418567391304349,10,143634
3,229865894,PZE-103185410,230182652,PZE-103185754,1.01386594202899,18,316758
3,230393273,PZE-103186042,230515826,PZE-103186325,0.397384615384614,13,122553
3,230658950,PZE-103186492,230993019,PZE-103186785,0.634574879227054,9,334069
3,231869118,PZE-103187082,232094969,PZE-103187455,0.780759510869567,16,225851
4,1220753,PZE-104005454,1255163,PZE-104005331,0.439830434782608,5,34410
4,3515393,PZE-104004415,3596029,PZE-104004501,0.649144927536233,3,80636
4,4477805,PZE-104006203,5010855,SYNGENTA2236,0.816322981366458,14,533050
4,5243745,SYN29999,5246710,PZE-104007604,0.58741304347826,2,2965
4,6386989,PZE-104009343,6413238,SYN9599,2.74495169082126,9,26249
4,7172555,PZE-104010129,7174847,PZE-104010147,1.03470652173913,2,2292
4,7448481,PZE-104010351,7618284,PZE-104010477,1.43909057971015,6,169803
4,9756254,SYN11697,9760095,PZE-104011271,1.0348768115942,3,3841
4,10479567,SYN34571,10483045,SYN34573,0.78508695652174,2,3478
4,11885526,SYN28715,12782818,PUT-163a-74244684-3688,0.952013043478261,15,897292
4,13126554,PZE-104014229,13130214,PZE-104014244,0.746065217391303,3,3660
4,13771270,PZE-104014546,14036462,PZE-104014780,0.979373188405797,6,265192
4,14507281,SYN12142,14541356,PZE-104015086,1.042,3,34075
4,15298119,SYN13983,15583336,SYN33244,0.59454347826087,9,285217
4,17829730,SYN8692,17830683,SYN8693,0.53284782608696,4,953
4,18117835,PZE-104018300,18209282,PZE-104018363,0.94352173913043,5,91447
4,18573717,SYN1501,18916144,PZE-104018885,1.97867598343685,21,342427
4,20054320,PZE-104019423,20102344,PZE-104019470,0.44254347826087,3,48024
4,20773159,PUT-163a-110206849-64,21220943,PZE-104019988,0.550478260869564,9,447784
4,22142582,SYN15294,22530923,PZE-104021070,1.13506956521739,10,388341
4,23727148,PZE-104022026,24112689,PZE-104022296,0.577297826086956,10,385541
4,26501203,SYN12649,26614895,PHM4901.9,0.228514492753623,6,113692
4,28027491,PZE-104024382,28124580,PUT-163a-76289863-3935,0.241375776397516,7,97089
4,28984241,PZE-104024876,28985737,PZE-104024889,0.320271739130435,2,1496
4,30199190,PZE-104025517,31108073,PZE-104025973,0.858404047976013,29,908883
4,31306276,PZE-104026267,32060613,PZE-104027060,0.288753623188407,9,754337
4,32791915,PZE-104027630,33361597,PZE-104027907,0.246741847826087,8,569682
4,34019505,SYN5775,34901943,PZE-104028825,0.966719806763288,18,882438
4,37937180,SYN23402,38029418,SYN30536,0.294517391304347,5,92238
4,39542254,PZE-104032365,41839551,SYN4255,1.2331309650053,41,2297297
4,41851034,PZE-104033489,44504375,PZE-104035067,0.779891304347829,48,2653341
4,49413636,PZE-104036615,54100010,SYN14029,0.824224414715718,65,4686374
4,54102168,SYN14030,54509254,SYN33300,1.11919927536232,6,407086
4,56312802,PZE-104041266,56533267,PZE-104041384,1.33378985507246,3,220465
4,58033711,PZE-104042141,66935940,SYN25538,1.52574554269628,139,8902229
4,72244070,PZE-104047670,72852564,SYN1338,0.433464426877471,11,608494
4,75508334,PZE-104049103,81526478,PZE-104051553,0.628837450592885,88,6018144
4,82662652,PZE-104052129,83816571,PZE-104052705,0.662688963210705,26,1153919
4,96309068,PZE-104056726,96311472,PZE-104056745,0.467815217391305,2,2404
4,114274795,PZE-104059028,119471467,PZE-104060760,0.894456916996051,55,5196672
4,121371052,PZE-104061539,124525538,PZE-104062911,1.57685326086956,36,3154486
4,143073638,PZE-104071903,143716879,PZE-104072466,0.361798136645965,14,643241
4,144669255,PZE-104073328,144727138,PZE-104073340,0.332963768115943,3,57883
4,145622859,SYN19881,146508679,PZE-104074620,0.798658385093167,14,885820
4,149897244,PZE-104076112,150024400,PZE-104076193,0.48682608695652,3,127156
4,150464488,PZA02992.15,150578447,PZE-104076485,0.463343478260871,5,113959
4,151070221,PZE-104076713,151083374,PZE-104076760,0.832195652173913,4,13153
4,151538378,PHM15864.8,151712829,PZE-104077288,0.31545652173913,2,174451
4,153632998,SYN13967,153752770,PZE-104079495,0.776934782608696,5,119772
4,154047404,PZE-104079742,154047619,PZE-104079748,0.783717391304345,2,215
4,155771774,PZE-104081298,155805873,SYN29826,0.446449275362319,3,34099
4,156955443,SYN2340,156958698,ZM012531-0288,0.814014492753623,3,3255
4,156993573,SYN9094,156998152,SYN9091,0.3985652173913,4,4579
4,157481981,PZE-104083441,157494238,PZE-104083501,0.66663043478261,2,12257
4,157552735,PZE-104083652,157554508,PZE-104083655,0.587065217391305,2,1773
4,157911888,PZE-104083827,157998574,PZE-104084001,1.16508695652174,3,86686
4,160566675,PZE-104086354,161052575,PZE-104086655,0.884242028985507,15,485900
4,162678166,PZE-104087825,162694715,PZE-104087852,0.709684782608695,2,16549
4,163854931,PZE-104088837,163899358,PZE-104088885,0.363891304347826,5,44427
4,164252250,PZE-104089381,164263863,PZE-104089440,0.42089751552795,7,11613
4,165659907,PZE-104089684,165679619,PZE-104089746,0.729786231884057,6,19712
4,165967329,PZE-104090017,165973974,PZE-104090097,0.278135869565215,4,6645
4,167386415,PZE-104092149,169803287,SYN20407,0.657369082125603,45,2416872
4,170013191,PZE-104093478,170027668,SYN2254,0.45786956521739,3,14477
4,170518042,SYN24904,170651212,PZE-104093812,0.918013043478262,5,133170
4,172055122,PZE-104095695,172688558,PZE-104096016,0.757475155279503,7,633436
4,172833206,PZE-104096416,173210826,SYN2244,0.54160869565217,10,377620
4,173310967,PZE-104096880,173374308,PZE-104096936,0.703875776397518,7,63341
4,174850079,PZE-104098283,175135414,PZE-104098648,0.296160869565219,10,285335
4,175272679,PZE-104098756,175336292,PZE-104098918,0.634014492753622,3,63613
4,175734275,PZE-104099226,175748832,PZE-104099276,0.267517391304348,5,14557
4,175971942,PZE-104099380,175980752,PZE-104099386,0.36563043478261,3,8810
4,177055544,SYN2322,177150719,SYN2317,0.444322981366456,7,95175
4,177434367,PZE-104100822,178137657,PZE-104101522,0.637773913043478,10,703290
4,178385894,PZE-104101753,178502179,PUT-163a-110213635-72,0.369960144927538,12,116285
4,178888136,PZD00031.4,179610471,PZE-104102916,0.239239130434783,8,722335
4,179618154,PZE-104103112,179648507,PUT-163a-76921937-4020,0.834843478260869,5,30353
4,179787933,PZE-104103469,179801379,PZE-104103602,0.399695652173914,8,13446
4,180198366,PZE-104103773,180237417,PZE-104103873,0.264014492753623,3,39051
4,182009253,SYNGENTA6284,182732777,PZE-104106433,0.725862700228832,19,723524
4,182873665,SYN25010,183640675,PZE-104106994,1.05805434782609,16,767010
4,183921982,PZE-104107327,183979542,SYN9199,0.20378260869565,4,57560
4,184547096,PZE-104107835,184782238,ZM012702-0484,0.475876811594203,3,235142
4,185181356,PZE-104108415,185309844,PZE-104108579,0.610902173913045,2,128488
4,185567383,SYN21455,185696404,SYN21456,0.427040760869564,8,129021
4,185864898,PZE-104109619,186199447,PZE-104110016,1.44626630434783,12,334549
4,186830731,PZE-104110543,186840496,PZE-104110698,0.440608695652177,3,9765
4,187595277,PZE-104112413,188491838,PZE-104113287,0.78912787723785,17,896561
4,189905893,PZE-104114501,190372843,PZE-104114790,0.80639440993789,7,466950
4,192696360,SYN31491,192815334,PZE-104116963,0.581934782608696,3,118974
4,193892648,PZE-104117587,194978215,PZE-104118113,0.51469948849105,17,1085567
4,196977445,SYN34701,197527307,PZE-104120445,0.386224080267557,13,549862
4,198131913,SYN38524,198388578,PZE-104121489,1.03633816425121,9,256665
4,199278350,PZE-104122240,199597664,PZE-104122422,1.14738198757764,7,319314
4,199936446,PZE-104122677,201082850,PZE-104123821,1.05132672634271,34,1146404
4,201236558,PZE-104123974,202075058,SYN28069,0.25897826086957,18,838500
4,203098232,PZE-104125536,203936765,PZE-104126021,0.801414596273291,14,838533
4,204668132,PZE-104126579,204861025,PZE-104126691,0.406798913043476,8,192893
4,205376489,PZE-104126927,205376547,PZE-104126928,0.213478260869565,2,58
4,205663186,PZE-104127010,207859632,PZE-104128161,0.643505610098177,31,2196446
4,208099922,PZE-104128326,208594051,PZE-104128500,1.26498447204969,14,494129
4,208875413,PZE-104128652,209229971,PZE-104128792,0.790360869565218,5,354558
4,209259453,PZE-104128889,209470107,SYN16580,0.23141304347826,6,210654
4,209798113,SYN6497,209976152,PZE-104129391,0.536391304347826,8,178039
4,212597324,PZE-104131099,214911222,PUT-163a-60348862-2597,0.345828557312249,44,2313898
4,215996510,PZE-104132610,216368472,PZE-104132899,0.403971014492752,12,371962
4,217522596,SYN492,218846053,SYN4631,0.998424818840579,24,1323457
4,225010211,PZE-104138027,225570280,PZE-104138269,1.32873913043478,12,560069
4,230800298,PZA03754.2,230800361,PZA03754.1,0.26395652173913,2,63
4,233005187,SYN11069,233024410,SYN11074,0.321445652173915,2,19223
4,233204685,PZE-104144387,233541810,PZE-104144719,0.583498327759202,13,337125
4,234567498,SYN28905,234571270,PZE-104146305,0.53630434782609,2,3772
4,234820975,PZE-104146792,234828089,SYN9319,0.298695652173917,3,7114
4,235081646,PZE-104147186,235209943,SYN13870,0.71186413043478,8,128297
4,235267930,SYN1161,235447529,PUT-163a-149095258-897,0.79121739130435,11,179599
4,235727057,SYN28881,235727670,SYN28884,0.33119565217391,2,613
4,236569763,ZM004771-0560,236756172,PZE-104150301,0.457178260869564,5,186409
4,237136783,PZE-104151091,237142280,PZE-104151167,0.74041304347826,2,5497
4,237268017,SYNGENTA13943,237442689,SYN7941,0.30721739130435,14,174672
4,237508697,PZE-104152306,237509462,SYN7917,0.447141304347825,2,765
4,237683341,ZM013346-0450,237704180,PZE-104152618,0.321934782608697,3,20839
4,238362623,SYN7814,238437442,SYN7835,0.509495652173911,10,74819
4,238744412,SYN38838,238932203,PZE-104154610,0.407231884057973,6,187791
4,238986146,SYN27082,238998536,PZE-104154777,0.425440217391303,4,12390
4,239370397,SYN39223,239370924,SYN39224,0.39919565217391,3,527
4,239682808,PZE-104156296,239702473,SYN21389,0.374857142857143,7,19665
4,240106598,SYNGENTA0879,240227508,SYN864,0.7084347826087,3,120910
4,240336675,SYN8790,240415965,SYN8787,0.335804347826087,3,79290
4,240456906,PZE-104157654,240457744,ZM012555-0370,0.30210869565217,3,838
4,240522833,PZE-104157783,241322382,PZE-104158108,1.7867214673913,16,799549
5,109141,PZE-105000098,914196,SYN33170,1.26045652173913,30,805055
5,1319392,PZE-105001477,1341465,SYN21480,0.80482608695652,10,22073
5,1525996,PZE-105001734,1534880,SYN21612,0.62492391304348,4,8884
5,1685686,SYN2358,1727484,SYN2371,0.739829192546586,7,41798
5,1898437,SYN14899,1954555,SYN35014,1.24273913043478,9,56118
5,2142037,SYN35353,2142403,SYN35352,0.74023913043478,3,366
5,2259905,PZE-105003682,2268991,PZE-105003736,0.50267391304348,2,9086
5,2283974,PZE-105003938,2308811,SYN33751,0.47567391304348,5,24837
5,2805104,SYN541,2805112,SYN538,0.364891304347826,2,8
5,3038486,SYN22678,3207115,PUT-163a-60350823-2646,1.11028449905482,23,168629
5,3538128,SYN9967,3539075,SYN9983,0.469152173913043,4,947
5,4766332,SYN5369,5105202,PZE-105011679,0.557239130434787,6,338870
5,5578832,SYN988,5623168,ZM015155-0206,0.643961956521737,4,44336
5,5926183,SYN3122,6139468,PZE-105014054,0.452832298136644,7,213285
5,6156859,PZE-105014188,6157091,PZE-105014190,0.24845652173913,2,232
5,6859778,PZA02462.1,6986417,PZE-105016060,0.718391304347827,9,126639
5,7137203,PZE-105016296,7140557,SYN8004,0.32209782608696,2,3354
5,7573972,PZE-105017202,7762829,PZE-105017654,0.93658862876254,13,188857
5,8460075,SYN38862,8549741,PZE-105018859,0.945178260869563,10,89666
5,9900694,SYN37837,9911057,SYN37836,0.331945652173912,4,10363
5,10009468,PZE-105020816,10101416,PZB00182.1,0.485559782608695,4,91948
5,10317293,PZE-105021734,11346813,PZE-105022649,1.07071321070234,26,1029520
5,11877562,PZE-105023608,11880075,PZE-105023645,0.474586956521735,2,2513
5,13052893,PZE-105025345,13280973,SYN14827,0.905963768115938,6,228080
5,14339487,PUT-163a-148947019-495,14611522,PZE-105028067,1.17922909698997,13,272035
5,15137526,SYN16500,15206848,SYN16499,0.646057971014493,3,69322
5,15321107,PZE-105029295,15435067,PZE-105029444,0.409551630434783,8,113960
5,16303939,SYN33294,16320604,PUT-163a-60350211-2639,0.7419347826087,2,16665
5,18583398,PZE-105033382,18622903,PZE-105033399,0.247108695652175,2,39505
5,19675006,PZE-105034591,19895817,PUT-163a-71422816-3214,0.439330434782607,10,220811
5,21415716,PZE-105036629,21988282,PZE-105036968,0.462140096618356,18,572566
5,23265300,PZA01427.1,23892316,PZE-105039096,1.50617913043478,25,627016
5,25619061,PZE-105040234,25661717,PZE-105040292,0.25529347826087,2,42656
5,30838566,PZE-105043494,31500587,ZM014286-0133,0.983239130434783,18,662021
5,31649634,SYN26666,31860788,PZE-105044315,1.85107357859532,13,211154
5,32614798,PZE-105044956,34801447,SYN28933,1.00984782608695,54,2186649
5,36470371,PZE-105047147,39672534,PZE-105048851,0.996065217391307,77,3202163
5,41360385,PZE-105049535,41365746,PZE-105049540,0.25179347826087,2,5361
5,42295067,PZE-105049918,42846769,PZE-105050370,1.02013405797101,24,551702
5,43647639,PZE-105050695,43649124,PZE-105050711,0.2453115942029,3,1485
5,46537873,SYN13540,46779865,SYN31657,0.2355652173913,9,241992
5,48144646,PZE-105052646,48384424,PZE-105052784,0.599580745341615,7,239778
5,50039829,PZE-105053944,50343804,SYN19035,0.348258695652174,10,303975
5,51215156,PZE-105054337,51361859,PZE-105054460,0.570166666666667,6,146703
5,53445250,PZE-105055664,54174129,PZE-105056273,0.233139492753623,12,728879
5,54964498,PZE-105056913,54992598,PZE-105056940,0.768260869565215,2,28100
5,57204446,PZE-105058689,58526144,SYN1422,0.946374223602484,28,1321698
5,61228987,PZE-105062126,64772178,PZE-105064367,1.1404746917586,67,3543191
5,65955730,PZE-105064915,66110865,PZE-105065076,1.21575217391305,5,155135
5,66424545,PUT-163a-28986827-1723,66429671,PZE-105065277,0.436369565217391,2,5126
5,67668163,PZE-105065918,67717686,PZE-105065975,0.707813043478261,5,49523
5,68389176,PZE-105066407,68428508,SYN38049,0.889121739130435,15,39332
5,69308623,SYN29079,70869157,PZE-105068275,0.618148272017835,39,1560534
5,71901166,PZE-105068797,72594596,PZE-105068930,0.54827173913043,2,693430
5,75884567,PZE-105071163,76942258,PZE-105072281,0.609396521739131,25,1057691
5,77098988,PZE-105072321,77445365,PZE-105072520,0.606015942028986,15,346377
5,80236358,PZE-105073770,80280742,PZE-105073786,0.65508695652174,3,44384
5,82952810,PZE-105075264,82970956,PZE-105075181,0.272342391304348,4,18146
5,83860601,PZB02425.3,85288112,PZE-105076693,1.43811204013378,26,1427511
5,86219837,PZE-105077140,86343387,PZE-105077266,1.00986086956522,5,123550
5,87923755,PZE-105077925,87926129,PZE-105077955,0.60521739130435,2,2374
5,89317871,PZA03049.23,93700856,PZE-105080933,0.56413043478261,88,4382985
5,103563997,PZE-105084730,127342468,PZE-105090603,1.45465255308392,172,23778471
5,127604425,PZE-105090714,129223679,PZE-105091436,1.3730652173913,25,1619254
5,130108935,PZE-105091716,136200439,PZE-105093758,0.420514899853448,89,6091504
5,139235302,PZE-105094920,142790101,PZE-105096931,0.378871439280358,58,3554799
5,143953728,PZE-105097486,143973644,SYN34725,0.2153115942029,3,19916
5,144714036,PZE-105098137,145108294,PZE-105098310,0.664173913043479,13,394258
5,145867921,PZE-105098804,147629967,SYN28772,0.646846880907372,23,1762046
5,148303883,PZE-105099743,148306204,PZE-105099711,0.274065217391304,3,2321
5,152878762,PZE-105101893,152933958,PZE-105101928,0.658394927536232,6,55196
5,155218025,PZE-105102856,155959609,PUT-163a-149014113-778,0.524888339920946,22,741584
5,155962380,PZE-105103204,158624147,ZM013547-0240,0.430367753623187,36,2661767
5,160711196,PZE-105105740,161281322,PZE-105106024,0.207230179028128,17,570126
5,163409720,PZE-105106949,163412726,SYN33594,0.595923913043475,4,3006
5,163743094,SYN1392,163985401,PZE-105107473,1.20211304347826,5,242307
5,164710608,PZE-105108017,164733011,PZE-105108057,0.409967391304347,4,22403
5,164883273,PZE-105108343,164985178,PZE-105108414,0.36763043478261,3,101905
5,168224869,PZE-105111257,168673145,PUT-163a-18177956-1457,1.10468414322251,17,448276
5,168890197,SYN34468,169668984,PZA03536.1,2.48452173913043,14,778787
5,170067880,PZE-105113193,170413976,PZE-105113493,0.404183574879231,9,346096
5,171202290,PZE-105114470,171711004,PZE-105114903,0.903585144927538,12,508714
5,175727442,PZE-105119214,178238731,SYN31361,1.34272044241037,57,2511289
5,179152915,PZE-105122079,180440398,PZE-105123697,0.573935354691076,38,1287483
5,181588001,PZE-105124618,182518953,PZE-105125362,0.801570332480818,34,930952
5,183149204,SYN1146,183321037,PUT-163a-149076210-846,0.398317934782609,8,171833
5,184161821,PZE-105126747,184234139,PZE-105127132,0.486030434782608,5,72318
5,184431515,PZE-105127434,184448878,PZE-105127504,0.320478260869565,2,17363
5,185577768,PZE-105128272,185666322,PZE-105128589,0.70360559006211,7,88554
5,186407979,PZE-105129024,186507410,PZE-105129248,0.35176086956522,5,99431
5,186726280,PZE-105129479,186970512,PZE-105130385,0.933494279176201,19,244232
5,187658800,PZE-105130823,187662469,PZE-105130833,1.05740760869565,4,3669
5,187848427,PZE-105130917,187849151,PZE-105130924,0.26373913043478,2,724
5,188389404,SYN16485,188389851,PZE-105131137,1.46197101449275,3,447
5,188463119,SYN16488,188477751,PZE-105131333,0.55044347826087,5,14632
5,188660453,SYN10270,188666818,PZE-105131631,0.433304347826085,2,6365
5,188829673,PZE-105132211,188834472,SYN35856,0.26036231884058,3,4799
5,188967385,PZE-105132637,189866304,PZE-105133450,0.689909782608696,20,898919
5,190732112,PZE-105134814,190741344,PZE-105134565,0.335423913043477,6,9232
5,192278889,PZE-105137112,192285622,PUT-163a-16918459-996,0.717543478260872,4,6733
5,196023222,SYNGENTA5631,196177961,SYN31099,0.932652173913043,12,154739
5,196787901,SYN28488,197606891,PZE-105142994,0.24910869565217,16,818990
5,197720714,PUT-163a-21390416-1527,197788438,PZE-105143481,0.27647826086957,4,67724
5,197947780,PZE-105143871,198044880,PZE-105144193,0.825592391304348,8,97100
5,198526942,PZE-105144626,198716544,PZE-105144767,0.674268115942027,3,189602
5,200649357,SYN11897,200877505,PZE-105148878,0.42286956521739,9,228148
5,201630584,SYN2083,201668024,PZE-105150212,0.27163768115942,3,37440
5,202394540,PZE-105151258,202827019,PZE-105151612,0.601385869565218,12,432479
5,203405146,PZE-105152305,203407056,PZE-105152296,0.740891304347826,4,1910
5,204605827,SYN1926,204759879,SYN7958,0.47517391304348,15,154052
5,206263616,PZE-105158473,206272652,PZE-105158503,0.892380434782609,2,9036
5,206557530,PZE-105158756,206572663,PZE-105158836,0.810376811594203,3,15133
5,207509606,PZE-105160703,207657718,PZE-105160952,0.352160326086956,8,148112
5,208254880,PZE-105163347,208341612,PZE-105163910,0.390695652173912,4,86732
5,209255165,PZE-105165545,209256794,PZE-105165547,0.36591304347826,2,1629
5,209291748,PZE-105165602,209471231,SYNGENTA13567,0.30905434782609,2,179483
5,209867354,SYN21851,210022668,PZE-105166637,0.285767080745343,7,155314
5,210691247,SYN29192,210752365,SYN28270,0.22884782608696,5,61118
5,211077275,SYN17485,211178921,SYN9392,0.34136956521739,4,101646
5,211281947,SYN3905,211520011,SYN2631,2.12159782608695,8,238064
5,211708477,SYN4380,211716520,SYN4379,0.43076086956522,2,8043
5,211763488,SYN22488,211939303,SYN18041,0.358813043478264,5,175815
5,212204526,PZE-105171924,212319875,SYN38866,0.907847826086957,7,115349
5,212748047,SYN35259,212819118,SYN35279,0.871725752508361,13,71071
5,213291931,SYN2950,213365136,SYN9405,1.50503557312253,22,73205
5,213726718,SYN25263,213726940,SYN25255,1.01667391304348,2,222
5,214283378,SYN33429,214284853,SYNGENTA12447,0.439760869565217,3,1475
5,214376946,SYN33425,214382086,PUT-163a-71427540-3259,0.6854347826087,3,5140
5,214517424,PZE-105178018,214845956,SYNGENTA10881,0.490420289855073,6,328532
5,215016341,SYN31305,215018403,SYN31322,0.53469565217391,2,2062
5,215622830,SYN33323,215626737,SYN33329,1.13732608695652,6,3907
5,215742501,PZE-105180820,215783463,PZE-105180858,0.501510869565215,2,40962
5,215991421,PZE-105181352,216164529,PUT-163a-71328889-3180,0.5410652173913,12,173108
5,216439893,SYNGENTA14200,216440431,SYNGENTA14197,0.477141304347823,4,538
5,216533976,PUT-163a-16927090-1168,216539556,PZE-105181902,0.332608695652175,2,5580
5,216644366,PZE-105182082,217708600,PZE-105182676,0.969126409017711,27,1064234
6,129643,PZE-106000007,659803,PZE-106000286,0.61115217391304,21,530160
6,1234387,PZE-106000504,1240386,PZE-106000516,0.885222826086955,4,5999
6,1535919,PZE-106000837,1537832,PZE-106000863,0.54084239130435,4,1913
6,1994553,PZE-106000993,2039806,PZE-106001089,0.48136956521739,2,45253
6,2882514,SYN22071,4802276,PUT-163a-149095867-899,0.470554054054051,37,1919762
6,4894009,PUT-163a-29130804-1741,4894329,PZE-106003981,0.352858695652175,2,320
6,6914558,PZE-106005688,8108778,SYN27273,0.748956521739131,8,1194220
6,9200467,SYN3415,17372369,PZE-106020831,0.661459954233408,38,8171902
6,17425840,PZE-106020840,18991117,PZE-106021420,0.977536231884057,21,1565277
6,20331355,PZE-106021644,21317002,PZE-106007374,0.6566884057971,6,985647
6,22664410,PZE-106007763,25581860,PZE-106008914,0.697465517241375,58,2917450
6,26561158,PZE-106009223,26717497,PZE-106009355,0.368760869565217,7,156339
6,27899230,PZE-106009925,27904433,PZE-106009923,0.338608695652175,2,5203
6,28146885,SYN36831,28225260,PZE-106010268,0.727920289855076,3,78375
6,31601533,PZE-106012204,32026839,PZE-106012528,0.57616996047431,11,425306
6,32456515,PZE-106012720,34455853,PZE-106013446,0.589710748792272,36,1999338
6,34978226,SYN17206,35091333,SYN26542,0.46560869565217,11,113107
6,35895383,PZE-106014445,35896206,PZA03063.21,0.211086956521739,5,823
6,40568194,PZE-106017215,40875092,PZE-106017319,0.632,3,306898
6,72859909,PZE-106031091,72868687,SYN35570,1.2360347826087,5,8778
6,78735781,SYN2644,81441236,PZE-106034719,0.937907826086956,50,2705455
6,82016672,PZE-106035094,82701408,PZE-106035421,0.297180434782609,10,684736
6,83930912,PZE-106036301,84787343,PZE-106037024,0.766217391304347,17,856431
6,85410480,PZE-106037346,85517575,PZE-106037482,0.5585,2,107095
6,86755707,PZE-106038725,88635583,PZE-106039871,1.20967978848414,37,1879876
6,88735705,PZE-106040109,88998736,SYN27726,0.66863768115942,9,263031
6,89885879,PZE-106041244,89888723,PZE-106041256,0.46945652173913,2,2844
6,91643101,PZE-106042198,91646266,PZE-106042232,0.394983695652172,4,3165
6,92304502,PZE-106042764,93328165,SYN2958,0.658691699604743,22,1023663
6,94500719,PZE-106045052,94518559,PZE-106045095,0.72325652173913,5,17840
6,95459971,PZE-106046093,95461184,PZE-106046094,0.28036956521739,2,1213
6,97339612,PZE-106048351,97804848,PZE-106048775,0.986086956521736,13,465236
6,98257387,PZE-106049277,98257427,PZE-106049278,0.25965217391304,2,40
6,100200639,PZE-106050388,100214304,PZE-106050426,0.24723913043478,2,13665
6,104113156,PZE-106053653,104275034,PZE-106053717,0.246621739130436,5,161878
6,104862051,PZE-106054188,104865093,PZE-106054189,0.310358695652175,2,3042
6,105926744,PZE-106055606,105952893,SYNGENTA2097,0.40880434782609,2,26149
6,106153240,PZE-106055794,106898387,SYN3042,0.93276086956522,19,745147
6,107169575,SYN21155,107178089,ZM013139-0345,0.28214492753623,6,8514
6,107591041,PUT-163a-31909945-2001,110152982,PZE-106059851,1.22613043478261,69,2561941
6,111678034,PZE-106057769,111707039,PZE-106057860,0.44918115942029,3,29005
6,112436068,PZE-106061688,112596521,SYN28805,1.23902173913044,8,160453
6,112803148,SYN38140,112818131,SYN26680,0.20134782608696,5,14983
6,113722033,PZE-106062728,115554474,PZE-106063999,0.649207280080889,43,1832441
6,115640112,SYN15518,115956908,PZE-106064355,0.829919254658384,7,316796
6,120739147,PZE-106067758,120959772,PUT-163a-86468823-4491,0.516891304347826,11,220625
6,123315131,PZE-106069603,123336768,PZE-106069625,0.249521739130435,2,21637
6,124531652,SYN7542,124709894,SYN32940,1.34413043478261,10,178242
6,129139474,PZE-106073551,129139869,PZE-106073554,0.44145652173913,3,395
6,129436903,PZE-106073719,129473249,SYN24361,0.339343478260868,5,36346
6,130131604,PZE-106075035,130161136,SYN19861,0.646608695652176,5,29532
6,130586557,PZE-106075377,131411390,PZE-106076029,2.12387351778656,22,824833
6,131991597,SYN3765,132431872,PZE-106077040,0.285295289855075,12,440275
6,132889427,PZA00250.1,133514256,PZE-106078099,1.58300334448161,26,624829
6,133816320,PZE-106078323,138187940,SYN15161,1.54560335968379,110,4371620
6,138930012,PZE-106081873,139620998,PZE-106082466,0.89207809983897,27,690986
6,140693501,PZE-106083274,140849014,SYN25253,0.869565217391305,11,155513
6,140913878,PZA02478.6,142454412,PZE-106085217,1.18765896739131,32,1540534
6,142950378,PZE-106085963,143955268,SYN22021,0.763760869565217,24,1004890
6,147137823,SYN27107,147209782,SYN28457,0.97915217391304,5,71959
6,150017729,SYN29970,150074555,SYN29969,0.214,5,56826
6,150737685,SYN11816,150742529,SYN11824,0.44052173913043,2,4844
6,150889413,PZE-106096872,151486586,PZE-106097584,0.576590792838875,17,597173
6,151795404,SYN26322,152212776,PZE-106098533,0.703920807453416,14,417372
6,152277265,SYN16935,152974712,SYN19380,0.658451086956524,12,697447
6,153655457,PZE-106100910,153661994,PZE-106101027,1.71669565217391,2,6537
6,154165245,SYN24459,154237741,SYN24465,0.35841304347826,7,72496
6,154322286,SYN10485,154322421,SYN10486,0.305913043478261,2,135
6,154326722,PZE-106102395,154782129,PUT-163a-28985344-1712,0.362821070234113,13,455407
6,155508945,SYN23855,155509795,SYN23873,0.213815217391305,4,850
6,155515953,PUT-163a-71768674-3531,155524834,SYNGENTA12830,0.305902173913045,2,8881
6,155757023,PUT-163a-71422538-3211,156692942,PZE-106106877,0.6768095952024,29,935919
6,156820261,SYN23621,156827327,SYN23623,1.64909420289855,3,7066
6,158259287,SYN19164,158282194,SYN19158,0.36597826086957,7,22907
6,158366537,PZE-106109825,158369685,PZE-106109857,0.892333333333333,3,3148
6,158445729,SYN10780,158447851,SYN10782,0.31468115942029,3,2122
6,159147552,SYN26097,159151310,ZM012369-0391,1.366,3,3758
6,159381451,PZE-106111790,159405032,PZE-106111839,0.49202173913043,4,23581
6,159616948,PZE-106112096,159825367,SYN27128,0.375577898550725,12,208419
6,160337381,SYN8244,160411245,PZE-106114215,0.2849347826087,6,73864
6,161446901,PUT-163a-71303230-3078,161452543,PZE-106115350,0.28182608695652,3,5642
6,161874523,PZE-106116583,161988333,SYN9305,0.587499999999999,8,113810
6,162186556,PUT-163a-60338619-2360,162384398,SYN32559,0.37953152173913,20,197842
6,162643617,PZE-106119113,162645229,SYN24539,0.51182608695652,7,1612
6,162686012,SYN22993,162689129,SYN22992,1.02873913043478,3,3117
6,162915541,SYN16021,163851231,SYN13318,0.490747181964575,27,935690
6,164891527,PZA02141.1,164901150,SYN10683,0.40054347826087,4,9623
6,165941397,SYN38609,166054160,SYN18594,1.75215942028986,15,112763
6,166254385,SYN7863,166254749,SYN7860,0.71989130434783,2,364
6,166629419,PZE-106128613,166828427,PZE-106128992,0.452576923076919,13,199008
6,167018795,PHM5529.4,167421872,SYN11439,1.25562560386473,18,403077
6,167691333,PZE-106131169,167702353,PZE-106131184,0.66030434782609,2,11020
7,726534,PZE-107000453,955291,PZE-107000462,0.806630434782608,6,228757
7,1138277,PZE-107000992,1226773,PZE-107001156,1.76707246376812,12,88496
7,1297354,SYN10738,1310254,PUT-163a-60347260-2574,0.42647826086957,10,12900
7,1972892,SYN36193,1975989,PZE-107002330,0.594108695652175,2,3097
7,2133651,PZE-107002578,2135320,SYN24975,0.30754347826087,3,1669
7,2582409,SYNGENTA14859,2963772,SYN24434,0.69405016722408,13,381363
7,3588989,PZE-107005360,3598960,PZE-107005367,0.96175,2,9971
7,4236601,PZB01083.4,4545566,SYN18499,0.823628260869565,10,308965
7,4703474,SYN37963,4795874,SYN37961,1.17884782608696,3,92400
7,5525020,SYN3807,5526782,PZE-107008540,0.367942028985507,3,1762
7,5797588,PZE-107008960,5978305,PZE-107009208,0.462836956521735,2,180717
7,6127634,PZE-107009409,6550521,PZE-107010082,0.791576086956518,6,422887
7,7410318,SYN19831,7524272,PZE-107011169,1.01188127090301,13,113954
7,8057494,SYN4536,8309270,SYN24999,0.795732514177697,23,251776
7,8701128,SYNGENTA6494,8929809,PZE-107012310,1.67123369565217,8,228681
7,9200061,SYN18116,9200919,PZE-107012564,0.494184782608695,2,858
7,9329135,SYN36572,9329883,SYN36579,0.429184782608695,2,748
7,9708272,SYN39338,9709489,SYN39339,0.60630434782609,2,1217
7,10163248,PZE-107013677,10549337,SYN19318,0.674543478260872,5,386089
7,10694586,SYN6900,10696065,SYN6897,0.21489130434783,4,1479
7,13959219,PZE-107016552,13980271,PZE-107016614,0.46510869565217,2,21052
7,14905655,PZE-107017377,15282338,SYN35761,0.891154891304346,16,376683
7,15416447,PZE-107017855,15543799,PZE-107018090,1.05063526570048,9,127352
7,17008049,PZE-107018773,17143015,PZE-107018798,0.333510869565215,2,134966
7,17470930,SYN15993,17697607,SYN27394,1.08383399209486,11,226677
7,21123106,PZE-107021664,21331332,SYN28353,0.99126708074534,21,208226
7,21869640,PZE-107022242,22014933,SYN27926,1.79217391304348,3,145293
7,24221272,PZE-107023462,24409023,SYN23593,0.409101449275363,3,187751
7,26860404,SYN20711,26864427,PZE-107024779,0.24746739130435,2,4023
7,27009126,PZE-107024936,27312619,PZE-107025115,1.11376482213439,11,303493
7,27420345,PZE-107025209,27480166,PZE-107025223,0.57361956521739,2,59821
7,29053955,PZE-107026046,36725971,PZE-107029600,1.97310908617547,167,7672016
7,37252556,PZE-107029827,39506033,PZE-107030605,1.14454869565217,25,2253477
7,43525552,PZE-107032603,44389799,PZE-107032987,0.89717391304348,20,864247
7,45117728,PZE-107033224,68348115,PZE-107036804,2.64694374044134,199,23230387
7,68866257,PZE-107036893,75985070,PZE-107039304,1.30379241261722,51,7118813
7,77594401,PZE-107039884,77600319,PZE-107039913,0.687673913043478,3,5918
7,79101130,PZE-107040458,79560286,PZE-107040678,1.06836956521739,8,459156
7,79560669,PZE-107040681,84124234,PZE-107042651,0.54165217391304,60,4563565
7,84488991,PZE-107042891,84503745,PZE-107042903,0.320724637681157,3,14754
7,84702418,SYN29842,85882473,PZA02291.1,0.855922038980507,29,1180055
7,86018931,PZE-107043608,86951134,PZE-107043997,1.13986392914654,27,932203
7,89033210,PZE-107044440,92275619,PZE-107045181,0.822033180778032,38,3242409
7,99541472,PZE-107050350,99955636,PZE-107050536,1.69224154589372,9,414164
7,100622093,PZE-107051266,101117580,PZE-107051567,1.39762888198758,14,495487
7,102759931,PZE-107052417,103666932,PZE-107052775,0.811697101449275,15,907001
7,105057954,PZE-107053716,105062294,SYN16732,0.47017391304348,3,4340
7,105067196,PZE-107053815,105368162,SYN14379,0.885456521739134,10,300966
7,106326475,PZE-107054656,106332162,PZE-107054663,0.233054347826087,2,5687
7,106638282,PZE-107054796,107237942,PZE-107055415,0.9665422705314,18,599660
7,107931299,SYN16553,108482809,PZE-107056322,0.497,10,551510
7,109052984,PZE-107056866,109056890,PZE-107056833,0.366884057971017,3,3906
7,109149980,SYN39188,109544586,PZE-107057306,0.403667701863354,14,394606
7,115550090,PZE-107060076,116382412,PZE-107060650,2.06166973244147,26,832322
7,116516541,SYN36347,117364240,SYN32778,0.50747826086957,10,847699
7,118312766,PZE-107062095,118427588,PZE-107062139,0.636847826086955,2,114822
7,118623967,SYN3200,119255159,PZE-107062740,0.645239130434783,8,631192
7,121574874,SYN13239,121986488,PUT-163a-148954504-535,1.73374130434783,10,411614
7,122449097,PZE-107065619,122449305,PZE-107065621,0.42052173913043,2,208
7,122988560,PZE-107066119,123488407,PZE-107066392,0.964428571428571,7,499847
7,125103412,PZB01186.3,125404626,PZE-107068730,0.929917874396135,9,301214
7,125858346,PZE-107068924,126642071,PZE-107069959,0.733350434782609,25,783725
7,127590835,SYN20393,127608827,PZE-107071389,0.26528260869565,3,17992
7,128121229,PZA00370.1,128121511,PUT-163a-89248979-4620,0.436317391304346,5,282
7,128647778,PZE-107072354,128870852,PZA01690.1,0.86849565217391,10,223074
7,129264180,SYN27282,129265357,PZE-107072681,0.81998913043478,2,1177
7,129344816,PZE-107072975,129970180,SYN28756,0.703963768115942,21,625364
7,131436957,PZE-107076252,132072680,SYN29954,2.01999516908212,9,635723
7,132157598,PZE-107076827,132164876,SYN29953,0.27352173913043,7,7278
7,132591806,PZE-107077474,132632787,SYN35079,0.36980434782609,2,40981
7,133624271,PZE-107078770,134038950,SYN8213,0.558462450592882,11,414679
7,134086753,SYN22397,134138810,PUT-163a-76293504-3970,0.45483913043478,10,52057
7,134708177,PZE-107079956,134848356,SYN13957,0.236766304347825,4,140179
7,136442729,PZE-107082043,137237223,PZE-107081543,0.71337971014493,15,794494
7,138097861,PZE-107080365,139691522,PZE-107084289,0.509441304347824,30,1593661
7,141676398,SYN6941,141905228,SYN22160,0.62602173913043,18,228830
7,142686960,SYN9448,143050284,PZE-107088012,0.615714492753624,15,363324
7,143203880,PZA03258.2,143394871,SYN24399,0.419178260869564,5,190991
7,145743412,PZE-107090737,146497491,PUT-163a-148951746-518,1.25485565217391,25,754079
7,148684622,PZE-107093938,150009618,PZE-107094672,0.365469845722303,31,1324996
7,152819823,PZE-107097588,153175123,SYN22194,0.391136363636363,11,355300
7,155703825,PZE-107101504,155745285,SYN3465,0.37491304347826,3,41460
7,155835519,PZE-107101793,156023967,PZE-107102135,0.312952173913044,5,188448
7,156501153,SYN10135,156644703,SYN3654,2.16052173913043,7,143550
7,159230980,SYN18575,159759568,PZE-107108200,0.422028985507247,15,528588
7,159859201,SYN12178,160028651,SYN29620,1.59865217391304,10,169450
7,160082017,PZE-107109140,160588993,SYN14115,0.856763586956521,24,506976
7,161949846,PZE-107112738,161951423,PZE-107112786,0.34117391304348,2,1577
7,162205078,PZE-107113582,162322330,SYN8375,1.13459937888199,7,117252
7,163046499,PZE-107115307,163232404,SYN18553,0.229346014492753,12,185905
7,164071283,PZE-107116723,164457184,PZE-107117132,0.426572981366461,14,385901
7,164825106,SYN7521,164829443,SYN7511,0.56532608695652,4,4337
7,164987683,SYN23691,165033000,SYN33698,0.21480434782609,4,45317
7,166370636,PZE-107120907,166565966,PZE-107121307,0.724774844720496,14,195330
7,167715777,PZE-107123571,167716078,PZE-107123572,1.58036956521739,2,301
7,168090539,SYNGENTA6303,168201559,SYN3263,0.946866459627326,7,111020
7,169094842,PUT-163a-60399196-2989,169204328,SYN17015,0.809721014492758,6,109486
7,170113992,PUT-163a-60394076-2895,170248232,PZE-107127708,0.23126086956522,2,134240
7,172158108,PZE-107131127,172207610,SYNGENTA5289,0.739169565217392,5,49502
7,172926096,SYN34109,172926640,SYN34110,0.21210869565217,2,544
7,174506330,PUT-163a-148942056-449,174537456,PZE-107136629,0.913934782608698,4,31126
7,174758501,PZE-107137037,174789034,PZB01638.1,0.839652173913043,5,30533
7,174864155,PZE-107137157,174864319,PZE-107137158,0.64763043478261,2,164
7,175200588,PZE-107137478,175206869,PZE-107137587,0.255597826086955,2,6281
8,618018,SYN9811,834322,PZE-108000731,0.522453416149068,7,216304
8,1831104,SYN10053,2111434,PZE-108002130,0.919671497584541,9,280330
8,2289509,PZE-108002184,2297367,PZE-108002202,0.538717391304348,3,7858
8,2870279,PZE-108002742,2901121,PZE-108002818,0.46567391304348,2,30842
8,3165657,PZE-108002941,3198251,SYN9921,0.28763043478261,2,32594
8,4234473,SYN27445,4234974,SYN27444,1.16530434782609,2,501
8,4281604,PUT-163a-18162342-1227,4285183,PZE-108004275,0.63384782608696,4,3579
8,4467681,PZE-108004477,4515790,SYN3176,0.350913043478261,6,48109
8,4958525,PZE-108004841,4959906,PZE-108004843,0.67119565217391,2,1381
8,5135666,SYN34214,5296079,PZE-108005219,0.439434782608698,4,160413
8,5894265,PUT-163a-71445680-3381,6104741,PZE-108006031,0.435350241545892,9,210476
8,6584683,SYN10427,6592041,SYN10432,0.73291304347826,4,7358
8,7039437,PZE-108007013,7039485,PZE-108007015,0.393,3,48
8,7748559,SYN20700,8138951,SYN22839,0.78884782608696,19,390392
8,8731594,PZE-108008825,8858054,SYN18177,0.977743478260868,5,126460
8,10071555,SYN12761,10084076,PZE-108009621,0.224544927536237,15,12521
8,10760848,PZE-108010180,10862428,SYN36560,1.29797391304348,5,101580
8,12903707,SYN36538,13001127,PZE-108012916,0.618795652173914,5,97420
8,13912154,SYN18494,14063476,PZE-108014189,0.57713043478261,3,151322
8,14087812,PZE-108014288,14701412,PZE-108014972,1.34669732441471,13,613600
8,15985128,PZE-108016243,15993755,PZE-108016333,0.2100652173913,5,8627
8,16759156,PZE-108016983,16850944,PZE-108017105,0.651384057971017,3,91788
8,17189449,ZM010920-0581,17392146,PZB01977.1,0.404243961352658,9,202697
8,18428996,PZE-108019050,18896226,PZE-108018598,0.945670289855075,12,467230
8,19510543,PZE-108020370,19516522,PZE-108020381,0.299644927536232,3,5979
8,19667400,PZE-108020467,20084931,PZE-108021167,0.339455242966749,17,417531
8,22173115,SYN35861,22506436,PZE-108023516,0.370546583850936,7,333321
8,22645609,SYN3484,22681697,SYN3485,0.58190760869565,4,36088
8,22796774,PZE-108024116,22822377,SYN10323,0.282978260869564,7,25603
8,23081945,SYN38349,23424735,PZE-108024691,0.887521739130433,5,342790
8,27116887,PZE-108029255,29090185,PZE-108027696,1.10320471014493,24,1973298
8,34453691,PZE-108030522,34663365,PZE-108030712,0.583226086956518,5,209674
8,35815240,PZE-108031355,37640027,PZE-108032269,2.59619983277592,26,1824787
8,48327742,PZE-108044999,48874246,PZE-108035025,0.24525652173913,5,546504
8,49592208,PZE-108035132,55514465,PZE-108036269,0.625448996655517,52,5922257
8,55934366,PZE-108036363,62555003,SYN19535,0.896503105590064,98,6620637
8,62557190,SYN19534,63145783,PZE-108038623,1.26804475703325,17,588593
8,65972918,PZE-108040469,66666215,PZE-108041018,0.553392976588629,13,693297
8,67354244,PZE-108041336,67381346,PZE-108041370,0.284573913043478,5,27102
8,69119155,PZE-108042149,69230818,PZE-108042194,0.220804347826087,3,111663
8,70548917,PZE-108042644,70752314,PZE-108042684,0.565273291925466,7,203397
8,70970609,SYN22141,70971475,PZE-108042739,0.428485507246377,3,866
8,73895797,PZE-108044406,75303538,PZE-108045495,0.99561272141707,27,1407741
8,75646966,PZE-108045901,79074879,PUT-163a-71307175-3090,1.30376909518214,74,3427913
8,79280537,PZE-108047286,85864051,PUT-163a-91873854-4775,1.37875537988581,99,6583514
8,85864192,PZE-108049642,86959998,PZE-108050089,1.74870903010034,13,1095806
8,87805034,PZE-108050391,88965277,PZE-108050850,0.577235507246377,24,1160243
8,90187564,SYN9235,90425756,PZE-108051282,0.424586956521739,12,238192
8,91386309,PZE-108051785,91424222,PZE-108051799,0.242572463768117,3,37913
8,91862643,PZE-108051988,91873848,PZE-108051997,0.25398913043478,2,11205
8,94578742,PZE-108052985,94696672,PZE-108053103,0.46781739130435,5,117930
8,95580373,PZE-108053588,96076158,SYN3403,0.670963043478264,20,495785
8,99158951,SYN20212,99161510,PZE-108055186,0.501478260869565,3,2559
8,99176891,PZE-108055230,99280801,PZE-108055317,0.444989130434781,4,103910
8,99969884,PZE-108055572,99970124,PZE-108055575,0.655282608695652,2,240
8,100397006,PZE-108055738,101116868,PZE-108056153,0.413342391304346,12,719862
8,101669727,PZE-108056593,101775535,PZE-108056704,0.439565217391303,6,105808
8,102263567,PUT-163a-74239932-3645,103192437,SYN21444,1.3306066252588,21,928870
8,103367952,PZE-108057905,103901056,PZE-108058222,0.806316576086961,16,533104
8,104462824,PZE-108058477,104463029,PZE-108058478,0.728891304347825,2,205
8,104819451,PZE-108058764,105132722,PZE-108058939,0.716101449275367,3,313271
8,106208165,PZE-108059416,106282153,SYN16948,0.534622282608696,8,73988
8,106743096,PZE-108059739,106855953,SYN18558,1.39715217391304,11,112857
8,107010896,PZE-108060017,109672709,PZE-108061148,0.934331174838113,47,2661813
8,109934768,PZE-108061313,109962068,SYN19060,0.21186956521739,4,27300
8,111196475,PZE-108062273,111825538,PZE-108062578,1.12942753623188,12,629063
8,112311645,PZE-108062772,113298023,PZE-108063396,1.49054628330996,31,986378
8,113716466,PZE-108063633,115406857,PZE-108064616,2.01680248447205,35,1690391
8,116305315,PZB01883.2,116867658,PZE-108065360,0.768725,20,562343
8,117437378,SYN27030,117572654,SYN37439,0.27852173913043,3,135276
8,117871384,PZE-108066080,118005735,SYN15980,1.20618695652174,5,134351
8,118401344,SYNGENTA14910,118787645,PZE-108067060,0.615018633540373,14,386301
8,119041845,PZA03509.1,119151487,PZE-108067429,0.288925465838511,7,109642
8,119583922,PZE-108067816,119643904,SYN2891,0.608253623188407,3,59982
8,119829842,SYN13443,119836405,SYN13435,0.40711739130435,5,6563
8,120014365,SYN20220,120875063,SYN12976,0.417056265984655,17,860698
8,121896035,PZE-108069434,123056834,PZE-108070194,0.749167798913044,32,1160799
8,123511872,PZE-108070393,123511998,SYN11935,1.532,2,126
8,124283503,PZE-108071011,124457676,PZE-108071309,0.83590579710145,6,174173
8,124792740,PZE-108071654,125198458,PZE-108072188,0.603597254004574,19,405718
8,125473101,PZE-108072485,125590026,PZE-108072532,0.583965838509316,7,116925
8,126077120,PZE-108072699,126080719,PZE-108072703,0.222798913043478,4,3599
8,128350315,PZE-108073496,128603188,PZE-108073672,1.20085217391304,10,252873
8,131584062,PZE-108076252,132003545,SYNGENTA17044,0.385551932367151,18,419483
8,132877586,PZE-108077348,133034210,PZE-108077447,0.42247826086957,5,156624
8,133179660,SYNGENTA0179,133562520,PZE-108077879,1.07510559006211,14,382860
8,135774948,PZE-108079531,136138158,PZE-108080073,0.594247491638795,13,363210
8,136415654,SYN27894,138264051,PZE-108081372,1.4005459486166,44,1848397
8,138390683,PZE-108081468,138795042,SYN7980,0.791980549199084,19,404359
8,140094813,PZE-108083275,140097654,PZE-108083286,0.99795652173913,2,2841
8,140460935,SYN3892,140582513,PZE-108083725,0.671599378881989,7,121578
8,142294302,PUT-163a-16925878-1123,142331208,PZE-108085309,0.388027173913042,4,36906
8,142668186,PZA03608.2,143009047,PZE-108085971,0.872398550724637,6,340861
8,143367589,PZE-108086277,143463648,PZE-108086333,0.266013043478261,5,96059
8,144021136,PZE-108086642,144374871,PZE-108086766,0.522394927536232,6,353735
8,144674461,PZE-108087001,144732487,PZE-108087165,0.857478260869565,4,58026
8,145082977,PZE-108087250,145140525,PZE-108087312,0.50867391304348,2,57548
8,145472295,PZE-108087997,145802542,PUT-163a-78074154-4087,1.01810507246377,18,330247
8,147715690,PZE-108090567,147726125,PZA03651.1,0.483891304347825,6,10435
8,148906011,PZE-108091606,148926877,PZE-108091593,0.42596739130435,2,20866
8,149148239,PZE-108092117,149304728,PZE-108092331,0.414920289855073,3,156489
8,149888147,PZE-108092820,149995293,PZE-108093081,0.372978260869562,5,107146
8,150671283,PZE-108093887,151022850,PZE-108094235,1.45366956521739,10,351567
8,151205062,PZE-108094442,151660037,PZE-108095253,0.312469565217392,10,454975
8,152323044,PZE-108095959,152768590,PZE-108096732,1.00848097826087,16,445546
8,155029958,PZE-108098682,155051934,PZE-108098736,1.73079347826086,2,21976
8,155636534,PZE-108099415,155653331,PZE-108099484,0.883385869565215,4,16797
8,156436697,PZE-108100367,156460638,PZE-108100441,0.32341304347826,3,23941
8,156574687,PZE-108100583,156638138,PZE-108100734,0.56766425120773,9,63451
8,156907697,PZA03696.2,156907918,PZA03696.3,0.210282608695652,3,221
8,157376501,PZE-108101499,157989796,PZE-108102648,0.783512228260869,16,613295
8,158442874,PZE-108102902,158762013,PZE-108103023,1.16265942028985,6,319139
8,158984163,PZE-108103193,159014083,PZE-108103365,0.901184782608697,4,29920
8,159952552,PZE-108105216,159989722,PZE-108105473,0.489232919254659,7,37170
8,161635677,PZE-108108010,161766769,SYN4196,0.46269565217391,4,131092
8,161838267,SYN9929,161901909,PZE-108108515,1.59782789855072,12,63642
8,162832884,SYN13353,162965158,PZE-108110131,0.28495652173913,6,132274
8,163115932,PZA03593.1,163220995,PZE-108110343,0.896681159420287,3,105063
8,163309859,SYN14062,163741671,SYN17500,1.0854347826087,18,431812
8,164898780,SYN30183,164900194,PZE-108113587,2.65744202898551,3,1414
8,165167224,PZE-108114003,165177307,PZE-108114046,0.476347826086957,3,10083
8,165989338,PZE-108116181,166484147,SYN12100,0.900875776397515,14,494809
8,166672371,SYN31086,166676070,SYN31082,1.03932608695652,2,3699
8,167782275,SYN26309,168275373,PZE-108120405,0.62975724637681,12,493098
8,169013325,SYN36468,169127002,SYN25130,0.798234782608696,10,113677
8,169624649,SYN21885,169792196,SYN34539,1.05625815217391,8,167547
8,171213375,PUT-163a-78089347-4225,171214402,PUT-163a-26557278-1605,0.28555797101449,3,1027
8,171302381,PZA00189.23,171598685,SYN11251,0.380207093821512,19,296304
8,172223355,PUT-163a-37416849-2023,172224419,PUT-163a-88749542-4536,0.706695652173916,5,1064
8,173177834,SYN11401,173251700,SYN11404,0.9085652173913,3,73866
8,173714715,SYNGENTA14235,173800087,SYN10419,0.65692753623188,6,85372
8,173975164,SYN22252,173977740,PZE-108134421,1.40630434782609,2,2576
8,174426316,SYN20804,174775584,PZE-108135302,0.60615217391304,12,349268
9,405220,PZE-109000243,415627,PZE-109000237,0.61230434782609,2,10407
9,1748837,SYN26170,1873703,PZE-109001327,0.524847826086955,2,124866
9,2119866,PZE-109001536,2213682,PZE-109001692,0.810652173913044,6,93816
9,3477153,PZE-109002854,3477314,PZE-109002852,0.23208695652174,2,161
9,3840821,PZE-109003288,4115556,SYN28653,0.55404347826087,15,274735
9,4652228,SYN30861,4840954,SYN22277,0.35141304347826,5,188726
9,5288476,PZE-109004775,5348891,PZE-109004718,0.58346376811594,3,60415
9,5876629,PZE-109005303,6006934,PZE-109005418,0.701340579710147,3,130305
9,7394666,PUT-163a-71426617-3241,7660754,SYN32614,0.739649068322981,7,266088
9,7958802,SYN39069,7960037,SYN39067,0.63517391304348,4,1235
9,8414792,SYN13447,8415633,SYN13449,1.72047826086957,3,841
9,8741151,PZE-109008133,8954555,SYN20003,2.02509782608696,10,213404
9,10131375,PZE-109009342,10277078,PZE-109009392,0.43397826086957,3,145703
9,10597435,PZE-109009601,10630759,PZE-109009619,0.437489130434785,2,33324
9,11217681,PZE-109010252,11233351,SYN31947,1.12392028985507,3,15670
9,11778827,PZE-109011385,12343404,PZE-109011715,2.04137608695652,20,564577
9,12621579,PZE-109011993,12983891,PZE-109012555,0.565493478260868,10,362312
9,13429438,PZE-109012939,13452442,PZE-109013008,1.64363768115942,6,23004
9,13915168,PZE-109013689,13915213,PZE-109013690,0.235902173913045,2,45
9,14535102,SYN11769,14577580,PZE-109014671,0.654052795031056,7,42478
9,15610493,PZE-109015513,16179673,PZE-109015923,0.444682065217391,16,569180
9,16680615,SYN16077,16728980,SYN16080,0.24486956521739,6,48365
9,17640512,PZE-109017457,18620935,PZE-109018226,0.39398291925466,14,980423
9,19924238,PZE-109019565,19931621,PZE-109019592,0.385043478260867,3,7383
9,20971130,PZE-109021109,20976775,SYN15749,0.28660869565217,3,5645
9,21967141,PZE-109021713,22056017,PZE-109021854,0.38626086956522,7,88876
9,23059639,SYN34127,23210395,SYN6550,0.255521739130435,4,150756
9,23540249,SYN5266,23754839,SYN34182,0.55610869565217,4,214590
9,26477793,PZE-109025969,27015269,SYN32327,0.448971739130434,20,537476
9,32946981,PZE-109029553,42289811,PZE-109033621,1.51431672240803,130,9342830
9,47489777,PZE-109035799,66391333,PZE-109047415,1.06739670910401,181,18901556
9,66588888,PZE-109047293,67292782,PZE-109040519,0.531635265700482,9,703894
9,69790574,PZE-109039199,74136775,PZE-109043553,0.91714504076087,64,4346201
9,75758158,PZE-109044296,77638315,PZE-109045108,1.12788608695652,25,1880157
9,87977999,PZE-109050242,89206574,PZE-109050944,1.29357971014493,24,1228575
9,89543796,PZE-109051446,90009821,PZE-109051663,1.6285652173913,7,466025
9,93280586,PZE-109053707,96073942,PZE-109054943,1.81525217391304,55,2793356
9,99909644,PZE-109058064,101356895,PZE-109059124,1.81869635343619,31,1447251
9,102093277,PZB01899.1,102518991,PZE-109060220,0.623135869565217,12,425714
9,104847885,PZE-109062205,105501283,SYN34267,0.275812111801246,14,653398
9,105606078,PZE-109062535,105667576,PZE-109062557,0.368260869565215,2,61498
9,106037397,PZE-109063133,107840288,SYN35518,1.133625,20,1802891
9,108708874,PZE-109065881,109317794,PZE-109066387,0.402520186335403,14,608920
9,110713902,ZM001821-0944,111087331,PZE0003935166,0.33147826086957,11,373429
9,111665960,PZE-109067808,111906260,PZE-109068097,0.327817391304348,5,240300
9,113062409,PZE-109068897,113422360,PZE-109069073,0.497739130434787,3,359951
9,116272960,PZE-109071550,116443653,PZE-109071755,0.973608695652175,6,170693
9,117044750,PZE-109072385,117051754,PZE-109072454,0.983282608695655,2,7004
9,121587239,SYN4635,122834376,PZE-109075820,0.554467391304345,18,1247137
9,125563936,PZE-109077933,126721936,PZE-109078603,0.970684143222503,17,1158000
9,127426944,PZE-109079358,127650377,PZE-109079696,0.533408212560387,9,223433
9,128715601,PZE-109080799,128776360,PZE-109080813,0.443557971014493,3,60759
9,130494643,SYN3443,130884999,PZE-109082237,0.720717391304344,17,390356
9,131380721,SYN34097,131381147,SYN34099,0.36871739130435,3,426
9,131724860,PZE-109083049,132814746,SYN35841,0.510065217391305,10,1089886
9,134284675,PZE-109085547,134544459,PZE-109085791,0.90413043478261,9,259784
9,136040088,PZE-109087443,136084461,SYN27758,0.430695652173912,5,44373
9,136476503,SYNGENTA15117,136583562,SYN38269,0.801252717391305,8,107059
9,137411466,SYN7736,137413641,PUT-163a-94480077-4903,2.52018115942029,3,2175
9,137784138,PZE-109089873,137787366,PZE-109089936,0.717804347826083,3,3228
9,138014842,PZE-109090136,138312159,SYN8886,0.992043478260872,5,297317
9,139215281,PZE-109092156,139406597,PUT-163a-18173577-1400,0.571369565217391,9,191316
9,139954558,PZE-109093461,140219941,PZE-109093912,0.352391304347824,13,265383
9,141469803,SYN11597,141476998,SYN11601,1.30780434782609,6,7195
9,142945372,SYN30951,142957174,PZE-109097755,1.31789673913044,4,11802
9,143897835,SYN27711,143906100,PZE-109098921,0.23121739130435,3,8265
9,144785153,PZE-109100121,144800224,SYN22241,1.22751086956522,4,15071
9,144882817,ZM008459-0215,145041919,PUT-163a-148938321-429,1.06552173913043,3,159102
9,146872932,PZE-109103540,146872957,PZA02197.1,0.20180434782609,2,25
9,147290584,PZE-109103952,147511324,PZE-109104633,0.953100000000001,20,220740
9,147615577,PZE-109104793,147616696,PZE-109104798,0.40458695652174,2,1119
9,147959320,PZE-109105874,147981914,PZE-109106057,0.478202898550727,3,22594
9,149119731,PZE-109107497,149169318,PZE-109107539,0.254644927536235,6,49587
9,149751906,PZE-109109031,149991030,PZE-109109342,0.528195652173914,11,239124
9,150644606,PZE-109109841,150715717,PZE-109109928,0.48419565217391,4,71111
9,151993440,PZE-109113950,152049003,PZE-109113974,1.10269565217391,5,55563
9,152494067,PZE-109115209,152646064,SYN8363,0.23547826086957,7,151997
9,152679459,SYN8354,152682249,PZE-109115639,0.43565217391304,2,2790
9,153562715,SYN24328,153610750,PZE-109118017,0.973292490118577,11,48035
9,153694093,SYN15948,153750609,SYN15966,2.7468152173913,6,56516
9,154565566,SYN6658,154605135,SYN23705,1.91213043478261,6,39569
10,1153778,PZE-110000228,1157706,PZE-110000234,0.412782608695655,2,3928
10,1543058,PZE-110000614,1631939,PZE-110000629,0.46970652173913,2,88881
10,1917824,ZM015154-0162,1919728,PZE-110001351,0.365326086956525,2,1904
10,2434554,SYN17621,2446890,PZE-110002415,0.68665217391304,7,12336
10,4527185,SYN14833,4528404,SYN14834,1.12141304347826,4,1219
10,4649550,SYN4482,4666194,SYN4496,0.37795652173913,3,16644
10,5725146,PZE-110007514,5739176,SYN17100,0.520239130434784,5,14030
10,6529762,PZE-110008784,6537612,PZE-110008833,0.257184782608695,2,7850
10,6591261,PZE-110008899,6659997,PZE-110008936,0.575190217391302,4,68736
10,7154635,PZE-110009334,7919113,PZE-110009748,0.77521739130435,11,764478
10,8276909,PZE-110009869,8355158,PZE-110009907,1.09623913043479,2,78249
10,8705031,PZE-110010024,8932315,PZE-110010401,1.02484492753623,15,227284
10,10142643,SYN12618,10284191,SYN12509,0.92760869565217,7,141548
10,10668926,PZE-110012284,10825299,PZE-110012360,0.826039130434783,5,156373
10,11195384,PZE-110012703,11195540,SYN4993,0.644702898550723,3,156
10,11722338,PZE-110013051,12102986,PZE-110013362,0.256389130434781,10,380648
10,14446603,PZE-110014871,14496228,PZE-110014882,0.668179347826085,4,49625
10,15393160,PZE-110015570,16508380,PZE-110016185,0.855093267882188,31,1115220
10,19643499,PZE-110017624,21551571,SYN16539,0.827937587657782,31,1908072
10,24605589,PZE-110019647,24612197,PZE-110019656,0.424926630434782,8,6608
10,25279249,PZE-110020065,25563165,PZE-110020166,0.779958333333334,12,283916
10,61384666,PZE-110032692,65475745,PZE-110034428,1.05540911835749,72,4091079
10,66016445,PZE-110034738,66174772,PZE-110034840,0.250710144927537,3,158327
10,67226379,PZE-110035502,67363148,PZE-110035567,0.30597463768116,6,136769
10,67933073,PZE-110035766,68815564,PZE-110036100,0.761391304347825,11,882491
10,69587659,PZE-110036445,70633663,PZE-110037004,0.69861652173913,25,1046004
10,74889415,PZE-110038912,75579226,PZE-110039214,0.486927536231883,3,689811
10,76638537,SYN22037,76645374,SYN22043,0.411521739130435,6,6837
10,77258388,PZE-110040162,77260315,PZE-110040193,0.64378260869565,2,1927
10,77534916,PZE-110040601,77556841,PZE-110040622,0.326913043478261,3,21925
10,78373012,PZE-110041090,79144162,PZE-110041371,1.35083913043478,10,771150
10,82175550,PZE-110043117,82850420,PZE-110043443,0.557451863354039,14,674870
10,83594630,PZE-110043783,84032130,PZE-110044119,1.42563526570048,9,437500
10,84071836,PZE-110044161,84072087,PZE-110044163,0.4256884057971,3,251
10,85834561,PZE-110045482,86102436,PZE-110045612,0.349391304347827,6,267875
10,91358505,PZE-110048719,91929519,PZE-110049046,0.476443734015344,17,571014
10,92033667,PZE-110049179,92034110,PZE-110049183,0.36245652173913,4,443
10,93277338,PZE-110049572,93686654,PZA03530.2,1.04162111801242,7,409316
10,94155639,PZE-110049863,94200010,PZE-110050012,0.406543478260869,3,44371
10,94698918,PZE-110050177,94727615,ZM009620-0299,1.04161956521739,2,28697
10,95123609,PZE-110050401,99108072,PZE-110052414,1.19016062801932,54,3984463
10,99471557,PZE-110052967,99622638,PZE-110053003,0.342296195652174,8,151081
10,101892272,PZE-110053754,101933970,PZE-110053819,0.502333333333333,3,41698
10,103632968,PZE-110054529,105855168,PZE-110055163,0.255652173913043,15,2222200
10,106460385,PZE-110055538,107313860,PZE-110055826,0.87184782608696,21,853475
10,107762334,SYN17940,108359988,PZE-110056279,0.66694565217391,18,597654
10,113712257,SYN16793,113943489,PZE-110059855,0.575900000000002,15,231232
10,114114444,SYN35611,115440570,PZE-110060993,1.34455539971949,31,1326126
10,117855995,PZE-110062942,117898171,PZE-110062953,0.32891304347826,2,42176
10,117991482,PHM13687.14,118836695,PZE-110063475,0.66523913043478,13,845213
10,123821658,PZE-110067273,124068190,SYN15050,0.22458695652174,7,246532
10,126143032,PZE-110069267,126652300,PZE-110069715,0.573195652173913,12,509268
10,127247580,PZE-110070241,127261630,PZE-110070387,0.331065217391305,4,14050
10,132954431,ZM013979-0369,132970062,PZE-110077699,0.484486956521738,5,15631
10,133714022,PZE-110079148,133714104,PZE-110079152,0.30704347826087,2,82
10,134057772,PZE-110079791,134719287,PZE-110080741,2.552192431562,27,661515
10,135327236,PZE-110082048,135330973,PZE-110082080,0.598282608695655,2,3737
10,136105175,PZE-110083653,136106175,PZE-110083667,0.253532608695655,2,1000
10,136933670,SYNGENTA0377,136934188,SYNGENTA0391,0.525311594202897,3,518
10,137282014,PZE-110085687,137290148,PZE-110085760,0.98982608695652,3,8134
10,137952519,SYN9254,137995561,SYN18465,0.69708695652174,10,43042
10,138212884,SYN21905,138345648,PZE-110087958,0.53513043478261,5,132764
10,138882013,PZE-110088808,139011162,PZE-110088931,0.561978260869565,2,129149
10,139840628,PZE-110090412,140305449,PZE-110091103,1.04256211180124,14,464821
10,141297647,PZE-110093304,141298245,PZE-110093311,0.395184782608695,2,598
10,142034125,SYN9690,142281160,PZE-110095272,0.555353864734303,18,247035
10,142920500,SYN39312,143379597,SYN650,0.589024844720496,14,459097
10,143389788,PZE-110097576,143443359,PZE-110097736,0.370862318840578,6,53571
10,143933712,PZE-110098492,144446323,SYN15700,0.579757763975154,14,512611
10,145192899,PZE-110101412,145199309,PZE-110101513,0.782565217391305,2,6410
10,145397193,PZE-110102174,145397729,PZE-110102178,0.90145652173913,2,536
10,145620822,SYN11610,145894425,PZE-110102725,0.46104347826087,3,273603
10,146075877,SYN15271,146114945,SYNGENTA16137,0.392291925465838,7,39068
10,147118940,PZE-110105426,147150364,SYN22569,0.504072463768117,6,31424
10,147402365,PUT-163a-149100124-916,147404812,PZE-110106563,0.478260869565215,4,2447
10,147579602,PUT-163a-50325618-2180,147838864,SYN19288,0.784467391304346,16,259262
10,148435462,PZE-110109001,148515533,PZE-110109454,1.11507453416149,7,80071
10,148998873,SYN36514,150096952,PZE-110111440,0.55541304347826,16,1098079
