chr,start,start_snpid,end,end_snpid,mex,nsnp,dis
1,325012,PZE-101000161,1205781,PZE-101000557,0.744821518559783,16,880769
1,1686635,PZE-101000754,1781003,SYN9660,0.29263834173913,3,94368
1,1957167,SYN10558,2210506,SYN6001,1.19923913043478,14,253339
1,2538655,PUT-163a-5499487-2275,2716163,SYN38926,0.597035572732917,7,177508
1,3035496,SYN11121,3078783,SYN11127,0.651399868550727,6,43287
1,3281217,SYN30755,3407925,SYN9368,0.76807312434783,12,126708
1,3708114,SYN11494,3733167,PZA02129.1,1.08020874869565,8,25053
1,3882714,PZE-101004387,3889632,SYN15069,0.32047924673913,2,6918
1,4758551,PUT-163a-50325923-2183,4758589,PUT-163a-50325923-2184,1.29993577347826,2,38
1,4862689,PZD00021.2,4994459,SYN11315,3.07667983826087,8,131770
1,5326925,SYN36149,5338021,SYN36146,0.94903161782609,6,11096
1,5728454,PZE-101009538,5954473,PZE-101009670,0.527148656376816,9,226019
1,6220407,SYN6318,6242103,PZE-101010560,0.537096506594202,6,21696
1,8351500,SYN35551,8355740,SYN35543,1.25337944391304,5,4240
1,8633468,PZE-101015469,9060038,SYNGENTA14387,0.9876329515415,11,426570
1,9358866,SYN21172,9359168,SYN21175,1.97038537913044,4,302
1,9433811,SYN14142,9435426,PZE-101016973,0.562388008115945,9,1615
1,9922610,PZE-101017463,9989779,SYN5905,1.00599802492754,3,67169
1,10547214,PZE-101018206,10589088,PZE-101018356,0.72707839231884,3,41874
1,11110601,PZE-101019334,11473826,PZE-101019597,0.65450592688406,6,363225
1,12189001,SYN33821,12189099,SYN33825,0.31503952478261,2,98
1,12517267,PUT-163a-89250869-4646,12522242,PZE-101021986,0.361017788509317,7,4975
1,12946006,PZE-101022796,13539363,SYN20039,0.577910628019324,9,593357
1,14507453,PZE-101024424,14943366,SYN33160,0.51737917322134,22,435913
1,15170841,SYNGENTA10955,15171509,SYNGENTA12708,0.284540515652175,2,668
1,15738968,ZM015125-0227,15808888,PZE-101026314,0.442273482976589,13,69920
1,16579851,SYN14297,16784593,PUT-163a-71311320-3110,2.98942440472826,8,204742
1,17714192,SYN30822,17843007,PZE-101029759,1.27163043478261,11,128815
1,18980563,PZA00358.12,18986228,PZE-101030925,1.27607707449275,3,5665
1,19699766,PZE-101032246,19699932,PZE-101032249,0.275069170869565,2,166
1,20419410,SYN24828,21682502,PZE-101033613,0.807747744440998,28,1263092
1,23218696,PZE-101035640,23246099,SYN13195,0.420918074268771,11,27403
1,24308521,SYN7039,24408873,PZE-101037142,0.35995059152174,2,100352
1,25411160,SYN16271,25426532,SYN16268,0.72341896869565,10,15372
1,26683529,PZE-101039400,26911913,SYN6258,0.620358198967391,8,228384
1,27379439,PZE-101040594,27502892,PZE-101040677,1.91814935428572,14,123453
1,27647570,PZE-101041070,27909410,SYN24633,0.33998023594203,3,261840
1,28796497,PZE-101042195,28796566,PZE-101042196,0.26554347826087,2,69
1,29550398,PZE-101043507,29757662,PZE-101043674,0.75353096057971,6,207264
1,30216622,PZE-101044115,31243619,SYN5392,1.21053386493537,37,1026997
1,32154688,PZE-101046735,32157097,PZE-101046755,0.425889327608695,2,2409
1,32871182,PZE-101047611,33123139,PZE-101047925,0.28458074391304,7,251957
1,33672182,PZE-101048890,33799525,PZE-101049044,0.21120553086957,2,127343
1,34896374,PZE-101050207,34940100,PZE-101050299,0.30234189753623,3,43726
1,37776401,PZE-101053715,38849559,PZE-101054681,0.604958006932364,36,1073158
1,39116930,PZE-101055223,39756606,PZE-101055906,0.780862976920287,12,639676
1,40354645,PZE-101056681,40519664,PZE-101057030,0.670724934308301,11,165019
1,41469604,SYN29246,41964321,PZE-101058210,0.627256006822743,13,494717
1,43059764,SYN2619,43669415,SYN12584,1.27922360010352,21,609651
1,43969797,PZE-101060218,44029521,PZE-101060288,0.31640880832298,7,59724
1,44956540,PZE-101061035,45004949,PZE-101061114,0.397571150608692,5,48409
1,46678570,PZE-101063406,46684873,PZE-101063527,0.29292984326087,2,6303
1,47772806,PZE-101064724,47993084,ZM013299-0478,0.757932311684781,8,220278
1,48684547,PZE-101065728,50713316,PZE-101067102,1.43885414419437,51,2028769
1,51017284,ZM003329-0547,52098757,PZE-101068888,0.756686020778987,24,1081473
1,53174005,SYN3086,53621515,PZE-101071092,0.660139241620557,11,447510
1,53666269,PZE-101071282,54603955,PZE-101072150,1.3002663678828,23,937686
1,54927904,SYN6669,55759948,PZE-101073078,1.21661337112649,22,832044
1,56573123,SYN11004,56573528,SYN11005,0.43992095043478,2,405
1,56892934,SYN37939,57299800,PZE-101074461,1.42464821843478,10,406866
1,57860369,PZE-101074618,58451321,PZE-101074969,1.38934935050167,13,590952
1,60261506,PZE-101076600,61033902,PZE-101077016,0.500056146225293,22,772396
1,62333065,PZE-101078026,63894760,PZE-101079397,0.554883762448514,38,1561695
1,67094239,PZE-101082298,67533887,SYN11221,0.59713297416149,7,439648
1,67727585,SYN24145,68563589,PZE-101081497,0.486100881501975,22,836004
1,69752187,PZE-101082523,69889217,SYN35770,1.29493506714286,7,137030
1,70581212,PZE-101083000,72012732,PZE-101083913,0.451278940465837,28,1431520
1,72094577,PZE-101083984,72353051,PZE-101084124,0.748963347747038,11,258474
1,73968220,PZE-101084898,73970623,PZE-101084888,0.47894762891304,2,2403
1,74215246,PZE-101085066,76619148,PZE-101086419,0.794767787852175,50,2403902
1,77146116,PZE-101086823,77259517,PZE-101087051,1.00393527554348,4,113401
1,80698037,PZE-101089047,80698058,PZE-101089048,0.43150197173913,2,21
1,81106413,SYN35629,82023292,PZE-101090371,0.239504283768118,12,916879
1,85716952,PZE-101093040,85835088,PZE-101093125,1.7800197673913,8,118136
1,86844203,PZE-101093764,86945134,PZE-101093782,0.6556620526087,2,100931
1,87562343,PZE-101094004,87602120,PZE-101094074,1.00294795753623,3,39777
1,87981466,PZE-101097131,88014649,PZE-101097273,0.885285661383399,11,33183
1,88711777,PZE-101097716,90230085,PZE-101098774,1.59145143955279,35,1518308
1,91503591,PZE-101099597,91504795,PZE-101099581,0.30808497678261,5,1204
1,91765543,PZE-101099705,91871289,PZE-101099739,0.323226284130435,2,105746
1,92218585,PZE-101094237,92246832,PZE-101094280,1.32220751260869,5,28247
1,92756783,PZE-101094707,93908636,PZE-101095712,1.75208537913043,25,1151853
1,96081157,PZE-101100007,98354440,PZE-101101331,0.386509186192714,37,2273283
1,99134559,PZE-101101730,99165872,PZE-101101737,0.508857047536232,3,31313
1,99664165,PZE-101101856,101780967,PZE-101102740,0.857788489480382,41,2116802
1,103614982,PZE-101103681,103621140,PZE-101103701,0.29311758847826,2,6158
1,105463896,PZE-101104380,105818604,PZE-101104606,0.738550958416147,14,354708
1,106061445,PZE-101104689,106159660,PZA00301.3,0.898310276376814,6,98215
1,112727165,PZE-101107431,119160652,PZE-101110353,0.486719239508009,76,6433487
1,148839744,PZE-101120882,149318021,PZE-101121077,0.94499012130435,12,478277
1,149549217,SYN29028,150183087,PZE-101121477,0.74514426895652,20,633870
1,150682455,PZA03028.5,154077833,SYN13856,1.42405189079153,39,3395378
1,155194840,SYN36885,156539020,PZE-101124568,0.890638698418972,22,1344180
1,158003719,PZE-101125154,158004739,PZE-101125163,0.227529646086957,2,1020
1,159728383,PZE-101126196,160336491,PZE-101126601,0.453435772478261,10,608108
1,162427809,PZE-101127891,164556608,PZE-101129057,0.493159916944773,37,2128799
1,164640160,PZE-101129119,166113150,PZE-101130002,0.890060603333333,30,1472990
1,167646371,PZE-101130854,167768977,PZE-101130898,0.233236167826089,2,122606
1,170473575,PZE-101132110,170961674,PZE-101132612,1.91655003357708,22,488099
1,172281609,PZE-101133195,172284467,PZE-101133216,0.22506917086957,6,2858
1,173235552,SYN2717,173661199,SYN38863,1.01893281086957,9,425647
1,173992552,PZB00963.2,174217484,PZE-101134601,1.27304348076087,8,224932
1,174375516,SYN26085,175292737,PZE-101135508,0.364059184713959,19,917221
1,175638197,PZE-101135767,176841773,PZE-101136693,0.596169446502837,23,1203576
1,178285219,PZE-101137593,178324217,PZE-101137700,0.755085227500001,8,38998
1,178493244,PZE-101137846,178689818,PZE-101137930,0.380337945391306,5,196574
1,179341109,PZE-101138198,179884817,PZE-101139056,0.885445279972826,16,543708
1,180612182,PZE-101139847,180693924,PZE-101139993,2.28428853391304,4,81742
1,180813135,PZE-101140149,182103926,PZE-101140981,1.06494507748231,43,1290791
1,182995323,PUT-163a-21390532-1529,183081478,PZE-101142054,0.43948616782609,2,86155
1,183842089,SYN1742,184632767,ZM013789-0350,1.07528292160183,19,790678
1,187635187,PZE-101144531,187637755,PZE-101144500,0.64789525782609,5,2568
1,188026235,PZE-101144893,188083114,PUT-163a-13178383-177,0.436978258869565,5,56879
1,189638074,PZE-101146525,189641815,PZE-101146530,0.388443675434785,2,3741
1,190998267,SYN29733,191091858,SYN14208,0.572203560241549,9,93591
1,191894620,PZE-101148449,191895721,PZE-101148471,0.29288043478261,2,1101
1,192101688,SYN15356,193321851,SYN35986,0.74418430670407,31,1220163
1,194729513,PZE-101151082,194801976,PZE-101151184,0.63334979782609,12,72463
1,195484495,PZE-101152052,195559029,PZE-101152132,0.993330040434783,4,74534
1,195755852,PZE-101152312,195770152,PZE-101152364,1.02407114594203,3,14300
1,196126460,SYN31534,196211069,SYN31537,0.49281620826087,5,84609
1,197269767,SYN38805,197392077,PZE-101154325,0.267779969710147,9,122310
1,197858175,PZE-101154881,198192767,PZE-101154963,0.462737152028983,3,334592
1,198473181,PZE-101155505,198479489,PZE-101155575,0.53150856753623,3,6308
1,198653310,PZE-101155676,198655438,PZE-101155685,0.791571149275363,3,2128
1,199106407,PZE-101156159,199117810,PZE-101156396,0.33365118554348,4,11403
1,199871129,SYN21424,199963599,PZE-101157488,0.55393774521739,2,92470
1,201868530,PZE-101159556,201872641,SYN38894,0.61177206608696,3,4111
1,202919228,PZE-100001836,203331217,PZE-101160748,0.44519403347826,11,411989
1,203647359,PZE-101160941,204073784,PZE-101161325,0.513383401391302,5,426425
1,204757632,PZE-101161747,205093780,SYN29665,0.349463577950313,7,336148
1,205186159,SYN34867,205412626,SYN10829,0.98666008086957,12,226467
1,206124271,SYN14326,206266073,SYN20516,0.45492095043478,4,141802
1,206459390,PZE-101163181,206859509,SYN37674,1.38262626333333,9,400119
1,207127152,SYN21493,207181873,SYN21485,0.3368750025,4,54721
1,207600263,PZE-101164344,207602786,PZE-101164360,0.342628458043479,2,2523
1,209182100,PZE-101166237,210465869,SYN14519,1.15902079496894,21,1283769
1,210996629,PZE-101167577,211005615,PZE-101167603,0.71281620326087,2,8986
1,211324869,PZE-101167962,211537448,SYN9052,0.688758235024154,9,212579
1,212168107,PZE-101168878,212532252,PZE-101169204,0.863738000869566,14,364145
1,212978084,SYN38571,213096535,PZE-101169609,0.301498939832776,13,118451
1,214842448,SYN38720,214888308,SYN38722,0.21609683521739,8,45860
1,216640256,PZE-101172726,216640679,PZE-101172733,0.52949604652174,2,423
1,216695411,SYN28640,217181526,SYN17605,0.26363636,12,486115
1,217450963,PZE-101173784,217617575,PZE-101173929,0.488328804347826,8,166612
1,217875936,PZE-101174158,219065665,SYN25300,0.530433597965217,25,1189729
1,221369064,PZE-101176624,222979756,PZE-101178021,0.82896880421325,42,1610692
1,223306532,PZE-101178411,223400905,PZE-101178225,1.34059683521739,5,94373
1,224070120,PZE-101179560,224100648,PHM12693.8,0.648527664347826,9,30528
1,224376338,PZE-101179967,224448452,PZE-101180060,0.477773986561267,11,72114
1,224783681,PZE-101180308,225589237,PZE-101181158,1.04276365428854,22,805556
1,225866807,PZE-101181384,225883687,PZE-101181505,0.558493083913045,2,16880
1,227119285,PZE-101182584,228005834,SYN37175,0.341395136467391,16,886549
1,230717634,PZE-101185989,230718643,PZE-101185998,0.20689722956522,2,1009
1,231181383,PZE-101186685,232396567,PZE-101187295,1.39153700847826,22,1215184
1,232520712,SYN27669,232742916,PZE-101187743,0.527603750679348,16,222204
1,233455298,PZE-101188202,233656904,PZE-101188466,0.409710616770184,7,201606
1,235833955,PZE-101190026,235864222,PZE-101190037,0.784486167826087,2,30267
1,237087198,PZE-101190927,237746143,PZE-101191529,1.01487154095652,10,658945
1,238604788,PZE-101192133,238607408,PZE-101192159,0.37857048536232,3,2620
1,238662122,PZE-101192195,238752707,PZE-101192304,0.526219369043476,5,90585
1,239616009,PZE-101192859,240282219,PZE-101193425,0.466494730695651,15,666210
1,242080955,PZE-101194985,243129246,PUT-163a-148991595-711,0.392781174703558,22,1048291
1,243462783,PZE-101195800,243462888,PZE-101195802,0.69986165826087,2,105
1,244756064,PZE-101196704,244826861,PZE-101196709,0.500765808913045,2,70797
1,246467917,PZE-101198224,246472571,PZE-101198252,0.264466400434785,2,4654
1,246546732,PZE-101198387,246663625,SYN20331,0.458606723913043,10,116893
1,246811542,PZE-101198633,247248905,PZE-101198768,0.352081685217392,9,437363
1,249091250,PZE-101199858,249091722,PZE-101199859,0.514372532826085,2,472
1,250094906,SYN8001,251142862,SYN30078,0.374770353913041,25,1047956
1,252736144,PZE-101201288,253109684,PZE-101201013,0.720979674254658,14,373540
1,253493820,PZE-101204633,253505855,PZE-101204728,0.46840579710145,3,12035
1,254094758,PUT-163a-148951459-517,254263888,PZE-101205609,0.441086957771739,8,169130
1,254464025,PZE-101205734,256466361,PZE-101207044,1.96836028220027,33,2002336
1,256566866,SYN34772,257950326,SYN10,0.96614089106884,24,1383460
1,258654877,PZE-101209279,258690094,PZE-101209438,0.29752470173913,2,35217
1,259272600,PZE-101209983,259408630,PZE-101210179,1.92867259521739,12,136030
1,260520076,SYN25458,260684675,SYN15085,1.08344861478261,7,164599
1,260920359,SYN2267,262167677,PZE-101211812,0.549187477707509,22,1247318
1,262171620,SYN30893,262513164,PZE-101212365,1.13507693555901,14,341544
1,264094317,PZE-101213680,264212108,PZE-101213906,0.798011635797102,9,117791
1,264502708,PZE-101214000,265437856,PZE-101214818,0.584807311268116,24,935148
1,265652447,PZD00084.2,266048142,PZE-101215416,1.08678988918972,22,395695
1,266094940,PZE-101215449,266095836,PZD00066.3,0.415143281086955,2,896
1,268558410,PZE-101217291,268736796,PZE-101217422,0.598356390289857,3,178386
1,269218944,PZE-101218080,269504831,SYN27384,0.464412053442029,12,285887
1,271025986,PZE-101219633,271126791,PZE-101219724,0.472848319021737,4,100805
1,271236170,PZE-101219849,271236346,PZE-101219854,0.27413043478261,2,176
1,271627282,PZE-101220098,271681138,PZE-101220121,0.9063833973913,2,53856
1,272555139,PZE-101221278,273232251,PZE-101221971,1.30503534687291,26,677112
1,273375012,PZE-101222284,273693583,PZE-101222445,0.511968601256039,9,318571
1,274722612,PZE-101223466,274942280,SYN11661,1.37549077938406,12,219668
1,275027776,SYN2652,275780292,PZE-101225496,1.58453217706522,32,752516
1,276325407,SYN16688,276816355,PZE-101226725,0.349217718816426,18,490948
1,277849479,PUT-163a-93011727-4797,279068468,PZE-101229323,1.09837712451406,34,1218989
1,280218373,SYN27285,280342748,PZE-101231477,0.95103755304348,3,124375
1,280829526,PZE-101232144,281071509,SYN32976,1.73006299168478,8,241983
1,281709021,PZA03188.3,281709732,PZE-101233861,0.563135706086957,3,711
1,283363772,PZE-101235826,283602884,SYN8669,0.391303111739131,8,239112
1,284500666,PZE-101236600,285111218,PUT-163a-74233187-3591,0.685088109202898,12,610552
1,285522004,PZA00245.19,285522115,PZA00245.14,0.593957512608695,2,111
1,285640719,PZE-101237912,285782998,SYN443,1.29287154095652,5,142279
1,286403940,PZE-101238868,286453013,PZE-101239020,0.753881423652173,5,49073
1,287983594,SYN7208,288491633,ZM012173-0545,0.75482213547826,5,508039
1,288854527,PUT-163a-78089980-4232,289221029,SYN21892,0.94811264913043,9,366502
1,291789227,SYN27559,291863331,SYN27560,0.7688833973913,3,74104
1,292134984,SYN3286,292138226,PZE-101246418,0.31023715369565,2,3242
1,292337146,PZE-101246580,292674753,SYN26421,0.303056290273752,27,337607
1,293269638,PZE-101247830,293628626,SYN38691,0.77933958884058,6,358988
1,293638311,SYN38692,293795952,PZA00235.9,1.8077470373913,4,157641
1,294728560,SYN31870,295311591,SYN8237,0.895047607957838,33,583031
1,296023133,SYN36179,296658750,SYN27361,1.05295501660456,21,635617
1,296769802,PZE-101252359,296847731,SYN26859,0.274644272956524,5,77929
1,298332124,SYNGENTA11155,298500739,SYN6844,1.10136364,7,168615
1,299045712,SYN7987,299047644,SYN7985,1.12419137007246,6,1932
1,299122439,SYN38953,299122448,SYN38955,0.23769268956522,2,9
1,299528185,PZB01937.2,299560371,PUT-163a-78092903-4261,1.15607707496894,7,32186
2,10232,SYN1722,1288990,SYN6180,1.15084762611304,50,1278758
2,3388933,PZB01233.2,3391541,PZE-102006513,0.429071147608695,2,2608
2,3614453,SYN2670,3614754,SYN2667,0.21655138521739,3,301
2,3735379,PZE-102007366,3739218,SYN9222,1.05131093695652,3,3839
2,4299784,SYN31108,4302909,SYN31118,0.78677865521739,3,3125
2,4365980,PZE-102009755,4371417,PZE-102009795,1.44194169869565,2,5437
2,4699070,SYN3554,4839270,SYN37569,0.92604743173913,6,140200
2,5818698,SYN29492,5827148,SYN29498,1.5881126527668,11,8450
2,6048795,PZA00237.7,6049080,PZE-102014236,0.600754280434783,3,285
2,6596480,PZE-102015478,6641601,PUT-163a-29946131-1834,0.464914361304346,3,45121
2,7950855,PZE-102017798,8293999,PZE-102018085,2.62970638018633,7,343144
2,8781646,PZE-102018300,8873169,SYN12998,0.46058300304348,13,91523
2,9109659,PZE-102019299,9126561,SYN1141,1.71037549043478,12,16902
2,9962876,PZA02272.2,9963196,SYN11391,0.550263505217391,3,320
2,9985308,SYN11386,9986953,SYN11378,0.295560770978262,4,1645
2,10344138,SYN5848,10368832,SYN5847,0.50546442869565,2,24694
2,10516860,PZA00620.2,10520160,SYN30586,0.564869072282612,4,3300
2,10603658,ZM002926-0696,10782867,SYN37974,0.534388872207359,13,179209
2,12103033,SYN7604,12103266,SYN7612,0.20291995956522,2,233
2,13351715,PZE-102028547,13351788,SYN6380,0.75323122347826,2,73
2,15892733,SYN14434,15995850,SYN7467,1.76412734331522,16,103117
2,17091639,PZE-102035948,17098690,SYN27288,0.54600790362319,3,7051
2,17435873,PZE-102036373,17544233,PZE-102036427,0.27707509608696,4,108360
2,17987600,PZE-102037297,18002381,PZE-102037347,0.273932807536233,3,14781
2,18618444,PZE-102038457,18643963,PZE-102038582,1.32745388775362,6,25519
2,19254164,PZE-102039123,19264939,PZE-102039283,0.920669469130435,4,10775
2,19325469,PZE-102039435,19326013,PZE-102039443,0.48939229021739,2,544
2,19439680,PZE-102039623,19986023,PZE-102039914,1.55260869565217,7,546343
2,20393117,PZE-102040639,20400259,PZE-102040682,0.40632411521739,2,7142
2,20536744,SYN9105,20565118,PZE-102041121,0.34872529826087,4,28374
2,23128751,PZE-102045174,23136328,PZE-102045227,0.468745058985512,6,7577
2,23317766,PZE-102045397,23888134,PZE-102046584,0.360583003043478,12,570368
2,24450345,PZE-102046941,25387853,PZE-102047571,0.579401958506617,23,937508
2,25733764,PZE-102047663,26849841,SYN700,1.2336586650559,35,1116077
2,27052498,PZE-102048896,27053394,PZE-102048901,0.35114130434783,2,896
2,27810298,SYN635,27960138,PZE-102049935,0.23305335695652,4,149840
2,28647597,PZE-102050935,28663063,SYN3949,0.474683791739132,4,15466
2,28703513,SYN3933,29119590,PZE-102051809,2.1889152420773,9,416077
2,29227238,PZE-102051839,29524205,PZE-102052096,1.05096442869565,5,296967
2,30872159,PZE-102053433,30906125,PUT-163a-78083518-4163,0.491926875652174,4,33966
2,32494945,PZE-102054468,33006611,PZE-102054921,0.832396248695653,6,511666
2,34539814,PZE-102056514,34574628,PZE-102056670,0.843730240108695,4,34814
2,34688541,PZE-102056752,36464512,SYN21191,0.790631981795842,23,1775971
2,36590474,SYN34233,36763506,PZE-102058084,0.28960770878261,10,173032
2,37046358,PZE-102058916,37906230,PZE-102059739,1.70186579144268,22,859872
2,38551092,PZE-102060229,38704465,SYN28278,0.591132129130434,14,153373
2,38989223,SYN28428,38989808,PZE-102060730,0.3549802326087,3,585
2,39429510,PZE-102061118,39621308,PZE-102061320,0.25095849347826,2,191798
2,40152831,PZE-102062050,40420387,SYN39135,0.7675197673913,6,267556
2,41300032,PZE-102062967,41775521,PZE-102063606,0.996782726445013,17,475489
2,42805299,PZE-102064901,44168023,SYNGENTA4218,0.786171850316206,22,1362724
2,47291870,PZE-102069280,47422259,PZE-102069429,0.857376483804348,4,130389
2,48108026,PZE-102069907,48108160,PZE-102069908,0.976175884782609,2,134
2,48823221,PZE-102070673,49952136,PZE-102071146,0.77112205257871,29,1128915
2,51280136,SYN38709,52318107,SYN394,0.528981289470105,32,1037971
2,54962529,PZE-102074393,54968268,SYN23126,0.354965414565218,4,5739
2,55241363,PZE-102074552,55894896,PZE-102075592,1.03776218605797,15,653533
2,57612220,PZE-102076300,58766265,PZE-102076876,1.22414750298419,22,1154045
2,59357377,PZE-102077123,60276380,PZE-102077620,0.824422852109501,27,919003
2,60874421,PZE-102078110,60875051,PZE-102078126,0.34373517695652,2,630
2,63372339,PZE-102079950,63490805,SYN19316,1.29122529826087,5,118466
2,63664884,PZE-102080062,63945188,PZE-102080267,0.771479744673913,12,280304
2,63949812,PZE-102080336,65513004,PZE-102081116,1.29995482796273,35,1563192
2,74307066,PZA03358.4,80331730,PZE-102087084,1.60607120641304,32,6024664
2,85477179,PZE-103095150,96840308,PZE-102090864,1.00328266276641,102,11363129
2,96840665,PZE-102090866,103818275,PZE-102092962,0.469215971019169,93,6977610
2,103825503,PZE-102092979,105782820,PZE-102093971,1.6180993103913,40,1957317
2,109878087,PZE-102095890,110826138,SYN7319,1.18737153695652,25,948051
2,110896614,SYN7302,118081991,PZE-102099902,1.24349468248531,74,7185377
2,118450007,PZE-102099996,118512028,SYN23028,1.06778161615942,6,62021
2,118981561,PZE-102100180,120283817,PZE-102100681,1.93853755304348,13,1302256
2,120436565,PZE-102100760,126763017,PZE-102103112,1.2482935324119,95,6326452
2,127443460,PZE-102103367,130956103,PZA02966.11,1.13063595202466,67,3512643
2,136179614,SYN32502,140973183,PZE-102109589,0.389242647258654,59,4793569
2,144169321,PZE-102111351,148193360,PZE-102113089,0.708948387787069,78,4024039
2,148506108,PZE-102113171,148669056,PZE-102113251,0.365744012966755,17,162948
2,148878787,SYN22871,150227222,PZE-102114289,0.941777310395256,22,1348435
2,150703575,PZE-102114510,150827059,PZE-102114638,0.656309287173913,4,123484
2,153014910,PZE-102115690,153400906,PZE-102115940,0.895519481428571,7,385996
2,153852007,PZE-102116113,153967493,PZE-102116215,0.856274702850242,9,115486
2,154602241,PZE-102116447,156399463,PZE-102117237,0.79050818863354,35,1797222
2,157292561,PUT-163a-149102041-931,157358259,PZE-102117605,0.626091895869563,2,65698
2,157899241,PZE-102117881,160262306,PZE-102118927,1.21775389704106,36,2363065
2,160541812,PZE-102118979,163727058,PZE-102120189,0.90808989980789,43,3185246
2,164092603,PZE-102120370,168555051,PZE-102122092,0.785884388744742,62,4462448
2,170457056,PZE-102123185,170457312,SYN29855,0.6252470373913,2,256
2,170854144,PZE-102123437,170875721,SYN25968,0.293922922173913,3,21577
2,173198310,PZE-102124275,173318361,PZE-102124335,0.354671937304348,5,120051
2,173777357,PZE-102124831,173779690,PZE-102124843,0.30094861978261,4,2333
2,175707652,PZE-102126234,175832030,SYN9559,0.469384054637683,3,124378
2,176244058,PUT-163a-13558106-270,177499135,PZE-102127702,1.00677957695652,43,1255077
2,177647002,PZE-102127751,177874858,SYN33463,0.549764823043481,10,227856
2,180157237,PZE-102129949,180626735,PZE-102130434,0.761586517246377,9,469498
2,180848700,PZE-102130733,180906049,PZE-102130760,0.360731226811595,3,57349
2,181843093,PZE-102131485,181917784,PZE-102131671,0.450286562173912,4,74691
2,182174755,PZE-102131796,182347126,PZE-102132005,1.07883838333333,9,172371
2,183184401,PZE-102132579,183200580,PZE-102132643,0.964143609710145,3,16179
2,184692191,PZA01735.1,184760284,PZE-102134499,1.15600649428572,7,68093
2,185171915,PZE-102135403,185645193,PZE-102136175,1.85155323497282,16,473278
2,186265441,PZE-102137410,186464021,PZE-102137628,0.929724730621116,7,198580
2,187368128,SYN28324,187881841,PZE-102139754,1.2301793870903,13,513713
2,188785081,PZE-102141224,188793764,PZE-102141193,0.23853425347826,3,8683
2,189224132,PZE-102141929,189275033,SYN7410,0.63213438826087,5,50901
2,189499840,SYN23963,189717808,PZE-102142917,0.617765276521739,13,217968
2,189937437,PZE-102143316,190024493,PZE-102143398,0.43294466630435,2,87056
2,190847523,PZE-102143832,190874820,PZE-102143943,0.279581687439613,9,27297
2,194037420,PZE-102147036,194043443,PZE-102147076,0.44208497978261,2,6023
2,195112487,PZE-102148331,195116659,PZE-102148393,0.96848485,3,4172
2,195541452,PZE-102148690,195918959,SYN24745,0.772910525810274,11,377507
2,196222019,SYN15388,196222087,PUT-163a-18163148-1243,0.20931818,2,68
2,197381535,PZE-102150762,197624296,SYN1761,0.752101150830039,11,242761
2,197935937,PZE-102151324,198019990,SYN192,1.114045454,5,84053
2,198435382,SYN21754,198583708,SYN25689,2.00909091,6,148326
2,198717467,SYN15809,198722781,PZA02017.7,0.65364624869565,4,5314
2,198859433,PHM7953.11,198905161,SYN35301,0.736139186770187,7,45728
2,199461566,SYN12065,199490908,SYN12056,0.368742585978261,4,29342
2,199696068,SYN6163,199888552,PZE-102153367,0.312436758347826,5,192484
2,202643907,SYN30953,203138838,SYN20471,0.682594771581028,22,494931
2,203254118,SYN26925,203633237,PUT-163a-149111560-968,1.23487339733696,16,379119
2,203844850,SYNGENTA11653,203902569,PZE-102156731,0.771627962608695,4,57719
2,204170506,PZE-102157204,204480666,PZE-102157814,0.972928193478262,6,310160
2,206855706,PZE-102160790,207160771,SYN5872,0.338657360353259,16,305065
2,207839969,SYN5620,208942469,PZE-102163621,0.687112726505015,26,1102500
2,209018141,PZE-102163959,209118283,PZE-102164292,0.311136365,2,100142
2,209254754,ZM013985-0322,209543656,PZE-102164997,0.543396517114624,11,288902
2,210031577,PZE-102165455,210313975,PZE-102165688,0.278586956521737,4,282398
2,210529271,ZM013948-0579,210531957,PZE-102166026,0.789263832173915,2,2686
2,211513926,SYN10133,211661987,PZE-102167636,0.498209484347828,5,148061
2,214661090,PZE-102171277,214666548,SYN27803,0.83078063195652,2,5458
2,217225065,SYN31065,217332336,SYN31462,0.38618577347826,5,107271
2,217841035,PZE-102175453,217880510,PZE-102175507,0.542243083913045,2,39475
2,218364466,PZE-102175641,218465089,SYN178,0.633988800144927,3,100623
2,219328524,PZE-102176625,219396738,PZE-102176758,0.347453061195653,4,68214
2,220764915,PZE-102178194,222163749,SYN21841,1.28240118304348,20,1398834
2,223310722,SYN18301,223310842,SYN18306,0.924031617826087,2,120
2,225703870,PZE-102183090,226323489,SYN889,0.67096838035573,11,619619
2,226977263,PZE-102184263,226978937,PZE-102184261,0.26290513652174,3,1674
2,228173501,PZE-102184611,228175265,PZE-102184643,0.405247037391305,2,1764
2,228871806,SYN15858,229120281,PZE-102185327,0.391172595217393,3,248475
2,229243916,PZE-102185458,229287540,PZE-102185494,0.33611330637681,3,43624
2,229478174,SYN6349,229978010,PZE-102186215,0.702902857591972,13,499836
2,230291137,PZE-102186367,230520837,SYN39026,0.305678520434785,6,229700
2,230866963,PZE-102186665,230868856,PZE-102186681,0.222129443913045,2,1893
2,231115198,PZE-102187119,231117913,PZE-102187115,0.208418973695655,2,2715
2,231296350,PZE-102187332,231660579,PZE-102187611,0.480322794057967,3,364229
2,232987692,SYN14630,232988341,PZE-102189528,0.366205535869565,2,649
2,233426438,SYN34408,233908519,SYN37311,0.459849455166241,17,482081
2,234718008,PZE-102192366,234723523,SYN6446,1.63095426118012,7,5515
2,235768324,PUT-163a-110194326-44,235783831,PZE-102193286,0.52863636,4,15507
3,1535911,PZE-103000858,1554959,SYN6355,0.749765317228259,8,19048
3,1715669,PZE-103001531,1852756,SYN13534,0.99306324565217,6,137087
3,2128761,SYN772,2131044,SYN776,0.5111561273913,4,2283
3,2445009,SYN39153,2451412,PZE-103003246,0.838949277584541,9,6403
3,2720684,SYN10214,2783611,SYN10209,0.3222529626087,5,62927
3,3107023,SYN34567,3311084,SYN34622,0.22237153695652,8,204061
3,3835786,PZE-103006822,3885697,SYNGENTA13501,2.43531620826087,10,49911
3,4546895,PZE-103007930,4680684,PZE-103008499,0.625377962608695,4,133789
3,4883149,SYN28478,4896318,PZE-103009187,1.16370553086957,9,13169
3,5572298,SYN31005,5751247,PZE-103010389,0.611180382371543,11,178949
3,5852699,SYNGENTA17024,5948485,PZE-103011490,0.702569170869563,3,95786
3,6796013,PZE-103013156,6802461,PZE-103013135,0.53019762891304,2,6448
3,7278922,PUT-163a-71306351-3085,7520134,PZE-103014248,0.573237150695648,5,241212
3,8976355,PZE-103015842,9038506,SYN13710,0.35595849347826,4,62151
3,9380181,SYN21250,9806074,PZA01765.1,0.494516908212558,9,425893
3,10274371,SYN7557,10388137,PZE-103017733,0.840098813879599,13,113766
3,10934638,PZE-103018718,11213554,ZM013910-0104,0.662789856739129,6,278916
3,11446488,PZE-103019236,11535267,SYN38416,0.86106324365217,5,88779
3,13312272,SYN37725,13504561,PZE-103021381,1.08315217391304,15,192289
3,15045494,SYN19249,15057297,PZE-103022853,0.633505931217392,5,11803
3,15214002,SYN33443,16309019,PZE-103023739,0.48371541956522,20,1095017
3,17019948,SYN27550,17034287,SYNGENTA10712,0.47349802826087,4,14339
3,18637400,PZE-103025781,18638996,PZA03309.1,1.41891551565217,4,1596
3,18994492,PZE-103025956,19083453,PZE-103026083,0.38532937985507,6,88961
3,19944061,SYN8204,19944116,SYN8205,0.23311758847826,2,55
3,20178794,PZE-103027495,20748202,PZE-103028171,0.644302810362321,18,569408
3,23011641,SYN555,23082971,PZE-103031083,0.628623188405793,3,71330
3,23177675,PZE-103031244,23263616,PZE-103031363,0.543776681478262,5,85941
3,23691943,PZE-103031582,23846812,PZE-103031701,0.56157361478261,4,154869
3,24223753,PZE-103031856,25865416,SYN36772,0.387124504750402,27,1641663
3,26313002,PZE-103033731,26316092,PZE-103033732,0.2304347826087,2,3090
3,28352349,PZE-103035153,28355478,PZE-103035210,0.253702237971013,3,3129
3,28920104,PZE-103035609,31104988,PZE-103037048,1.56657800027507,49,2184884
3,31652518,PZE-103037364,33850957,PZE-103038918,0.89070948634783,55,2198439
3,35353297,PZE-103039662,35353733,SYN12767,1.46670948434783,3,436
3,37092182,PZE-103041012,37238076,PZE-103041138,0.790691697786563,11,145894
3,38048617,PZE-103041556,38060107,PZE-103041578,0.285906617826085,4,11490
3,38602012,PZE-103041877,43524890,PZE-103044113,2.119138482277,97,4922878
3,45229812,PZE-103044839,45432237,PZE-103044948,0.425517128405796,3,202425
3,47601473,PZE-103045825,47603423,PZE-103045836,0.92605237108696,2,1950
3,48043020,SYN13453,48493599,SYN657,0.48823122147826,5,450579
3,49562562,PZE-103047128,52746998,PZE-103048931,0.48341896869565,43,3184436
3,53143525,PZE-103049110,54253578,PZE-103049829,0.988733831225294,22,1110053
3,54698138,PUT-163a-21481350-1571,55029718,PZE-103050226,0.515759881695652,10,331580
3,55475402,PZE-103050583,55672972,PZE-103050659,0.282035571304348,2,197570
3,56813579,PUT-163a-16927508-1172,57393000,PZE-103051733,1.7372024576087,18,579421
3,59601054,PZE-103052979,66343921,PZE-103055347,2.14733105799907,93,6742867
3,69965401,PZE-103056912,92490860,PZE-103061576,1.65096693722524,144,22525459
3,96177826,PZE-103062429,99229222,PZE-103063115,1.36745701517391,20,3051396
3,100732792,PZE-103063892,101665887,PZE-103064301,0.547366861258581,19,933095
3,106008242,PZE-103065661,107196502,PZE-103066354,1.08539571049407,22,1188260
3,107421465,PZE-103066496,111448581,PZE-103068051,0.304639629387349,66,4027116
3,111871873,PZE-103068203,111913098,PZE-103068224,0.457549406811593,3,41225
3,111963472,PZE-103068285,111971131,SYN38653,0.339881420652175,2,7659
3,112027496,PZE-103068422,114790935,PZE-103070324,0.673295939838021,51,2763439
3,116208615,PZE-103071002,118288461,PZE-103071922,0.4502359222962,32,2079846
3,118807567,PZE-103072120,119967521,SYN22862,0.67255929217391,23,1159954
3,119991018,PZE-103072825,121671775,PZE-103073496,1.08461507308301,22,1680757
3,122061563,PZE-103073631,123405178,PZE-103074652,1.13704837529644,44,1343615
3,125712719,PZE-103075826,127050081,PZE-103076395,0.720600074426876,22,1337362
3,127544472,PZE-103076950,127613386,PZE-103077003,0.27339130434783,5,68914
3,128881344,SYN9672,132690218,PZE-103080080,1.87881459873667,53,3808874
3,134867390,PZE-103081176,134908156,PZE-103081224,0.50564558478261,3,40766
3,134953445,PZE-103081284,136845464,PZE-103082585,0.738364295024152,45,1892019
3,140726385,PUT-163a-148941995-448,142695512,PUT-163a-16919470-1026,0.513099112003781,46,1969127
3,143091129,PUT-163a-22545381-1595,143802488,PZE-103086785,0.711714873636364,11,711359
3,144603884,PZE-103087157,145489675,PZE-103087649,0.459907041159418,27,885791
3,147010907,PZE-103088722,147292672,PZE-103088928,0.439023714869563,5,281765
3,147406521,SYN8458,148290971,PZE-103089806,1.4799464341762,38,884450
3,148977612,PZE-103090188,149408275,PZE-103090476,0.3427821705314,9,430663
3,150168319,PZE-103091138,150277608,PZE-103091189,0.571590907777777,9,109289
3,152182235,PZE-103092313,152202763,PZB01183.1,0.527282612028986,3,20528
3,156284109,PZE-103096409,156284786,PZE-103096420,0.20529150152174,2,677
3,156483037,PUT-163a-111190332-143,156639988,PZE-103096829,0.503816425120773,9,156951
3,157018354,PZE-103097270,158444676,PZE-103098174,1.73208278285024,27,1426322
3,158519162,SYN1189,158525361,PZE-103098294,0.591849474202898,6,6199
3,158888979,PZE-103098625,158901632,SYN25550,2.62143011304348,11,12653
3,160014652,PZE-103100020,160329761,PZE-103100160,0.41252305584541,9,315109
3,165725085,PUT-163a-16925568-1103,165858588,ZM010736-0201,0.497380524861662,11,133503
3,166011175,SYN14727,166033152,SYN38962,0.48445652173913,4,21977
3,166448477,PUT-163a-76293601-3974,168525546,PZE-103107609,0.851261003774705,44,2077069
3,168698586,PUT-163a-149099344-910,168862263,PZE-103107820,0.302203556630433,4,163677
3,169114452,PZE-103108302,169114492,PZE-103108303,0.59840909,2,40
3,169576793,PZE-103108648,170251185,SYN7262,0.765793807884058,15,674392
3,170436993,PZE-103109875,170444223,SYN23413,0.650731223478261,4,7230
3,170499681,PZE-103110183,170771737,PZE-103110416,0.420872389130436,7,272056
3,171894961,SYN37786,172050320,PZE-103111690,0.7422924873913,6,155359
3,172675399,PZE-103112970,173005115,SYN28495,1.79710968652174,8,329716
3,175554472,PZE-103115618,175562116,PZE-103115629,1.20461462086956,2,7644
3,176039818,PZE-103116639,176044879,SYN34014,0.61706521405797,3,5061
3,176677313,PZE-103118101,176791731,SYN1547,1.04143281086956,6,114418
3,177019447,PZE-103118331,177446587,PZE-103118562,2.11833915692308,13,427140
3,178411734,PZE-103119878,179126977,PZE-103120779,1.06981225304348,23,715243
3,180743388,PZE-103122966,180747973,PZE-103123019,0.36610672057971,3,4585
3,180899575,PZE-103123171,181124427,PZE-103123538,0.907087174492754,9,224852
3,182082245,PZE-103124964,182710864,SYN10562,0.38546442869565,22,628619
3,183084768,ba1.5,183323668,PZE-103125767,0.890798873010033,13,238900
3,183378880,PZE-103125803,183387458,SYN29702,0.577391304347826,6,8578
3,184155559,PZE-103126771,184194406,PZE-103126857,0.35033926521739,3,38847
3,184239673,PZE-103127045,184269632,PZE-103127134,0.22221343782609,2,29959
3,184434775,SYN1220,184606146,SYN23244,2.19616600608696,5,171371
3,184852313,PZE-103128261,185310180,SYNGENTA3276,0.265542716822738,13,457867
3,186214250,PZE-103129362,186563317,SYN20501,0.601371663315217,16,349067
3,186929492,SYN10950,186929813,SYN10949,0.70614624869565,3,321
3,187430601,PZE-103130832,187444268,PZE-103131061,0.774442691565218,5,13667
3,188091257,PZE-103132112,188454425,PZE-103132539,0.762515439211956,16,363168
3,188907726,PZE-103133175,188923508,PZE-103133192,0.638670950434785,2,15782
3,189985384,SYN5521,190062809,PZE-103134460,0.30741107173913,2,77425
3,193757793,PUT-163a-110967306-138,193758223,PUT-163a-149109030-949,0.24895256826087,2,430
3,195243738,PZE-103138943,195268058,SYN33683,1.21064558811594,3,24320
3,195377741,PZE-103139031,195514372,SYNGENTA14765,0.725176966640317,11,136631
3,195651099,PZE-103139324,195697956,SYN25916,0.59828063362319,3,46857
3,195935474,SYN37387,195941604,SYN37388,0.710592888405797,3,6130
3,196147847,PZE-103140478,196154842,PZE-103140670,0.433754941014497,3,6995
3,196351287,SYN6514,196569483,PZE-103141268,0.994122353122532,11,218196
3,197016376,PZE-103141529,198600428,PZE-103143078,0.742842554782608,39,1584052
3,199274499,PUT-163a-18176904-1455,199561516,SYN33373,1.12256422652174,8,287017
3,199828443,SYN31493,200311070,PZE-103145363,1.2285711456087,10,482627
3,200396129,PZE-103145512,200426061,PZE-103145531,0.761660080869567,3,29932
3,201180601,SYN8109,201249293,PZE-103146632,0.759278655217391,8,68692
3,201324806,SYN32692,201541112,PZE-103147212,0.768755703478263,13,216306
3,202038436,SYN15017,202431257,PZE-103148470,0.523795562318841,9,392821
3,202762352,PZE-103148720,202766729,PZE-103148727,0.33007246710145,3,4377
3,202829563,SYN28290,203895038,PZE-103149689,0.601663669940711,22,1065475
3,204283178,PZE-103150004,204286171,PZE-103150034,0.89371047521739,2,2993
3,205007622,PZE-103151098,205016863,SYN18659,0.262228260869565,2,9241
3,205407552,PUT-163a-148964486-613,206617131,PZE-103153359,0.845008590604918,23,1209579
3,206959062,PZE-103154125,206959086,PZE-103154126,0.24735177956522,2,24
3,207470669,PZE-103154589,207555271,PZE-103154688,0.25392588978261,10,84602
3,207716022,PZE-103154782,207755615,PZE-103154903,0.221543973695652,4,39593
3,208058223,PZE-103155445,208063825,PZE-103155456,0.33834980449275,3,5602
3,208414114,SYN1298,208830533,SYN28061,1.36711462086957,13,416419
3,209726284,PZE-103157683,209729610,SYN34624,1.17399802026087,5,3326
3,210267125,SYN20828,210508497,SYN32112,0.52254940347826,14,241372
3,211123147,PZE-103159840,211146674,PUT-163a-148946654-491,0.762952896884057,6,23527
3,212156590,PUT-163a-86473168-4518,212445689,PZE-103161873,0.526510336020066,13,289099
3,213800881,SYN36395,214208285,PZE-103164338,0.37321146608696,5,407404
3,214305947,SYN35424,214476991,PZE-103164677,0.720713928260868,4,171044
3,214899677,SYN36904,214900353,SYN36909,1.31827074826087,4,676
3,215087731,PZE-103165697,215218459,PZE-103165871,0.309558631594203,3,130728
3,215850087,PZA03146.2,215902752,PZE-103166909,0.35230237608696,4,52665
3,216483610,PZE-103167938,216877039,PZE-103168273,0.96324110217391,11,393429
3,217571921,SYN31519,217631510,SYN31517,0.50221343782609,3,59589
3,217694579,SYN31527,217899034,SYN6765,0.793752612301792,17,204455
3,219787043,SYNGENTA15602,220686743,PZE-103174030,0.727164970414078,21,899700
3,221158246,PZA03360.1,221439853,SYN20072,0.92182081965217,15,281607
3,221688583,PZE-103175779,222451007,PZE-103176477,0.724503951478262,10,762424
3,223083077,PZE-103177259,223090872,SYN24268,0.870889327608695,4,7795
3,223680598,PZE-103177746,223683787,PZE-103177781,1.02375164811595,6,3189
3,223737353,ZM014594-0272,223752352,PZE-103177974,0.639703559130436,5,14999
3,224487247,PZE-103179078,224631614,SYN4283,0.668685773478261,11,144367
3,225090282,PZE-103179884,225823377,SYNGENTA11784,1.26987683411491,28,733095
3,226957117,SYN29677,226957202,PZE-103181990,0.41211462086957,2,85
3,227128965,PZE-103182399,227129108,PZE-103182400,0.680533594565217,2,143
3,227274031,PZE-103182712,227413494,PZE-103182953,0.367955776086959,8,139463
3,227486499,PZE-103183147,227624308,PZE-103183235,2.39993082913043,5,137809
3,228451330,PZE-103183786,228451397,PZE-103183787,0.39821146108696,2,67
3,229241840,SYN4876,229261950,PZE-103184458,0.29972331652174,5,20110
3,229865894,PZE-103185410,230177187,ZM013829-0406,0.89704175048913,16,311293
3,230253707,PZE-103185889,230788139,PZE-103186661,1.34054464075447,34,534432
3,231088786,PZE-103186820,231114743,PZE-103186829,0.408415679130437,3,25957
3,231869118,PZE-103187082,232094969,PZE-103187455,1.32702939899457,16,225851
4,825132,PZE-104000439,1047561,PZE-104001238,0.321077075098815,11,222429
4,1150893,PZE-104001296,1255163,PZE-104005331,1.4092588921118,7,104270
4,2833183,SYN17713,2836560,SYN17710,0.28966403434783,5,3377
4,3595187,PZE-104004499,3596029,PZE-104004501,0.670350788695655,2,842
4,4477805,PZE-104006203,5010855,SYNGENTA2236,0.623615189937886,14,533050
4,5243745,SYN29999,5266889,SYN29997,0.40967720594203,3,23144
4,6386989,PZE-104009343,6413238,SYN9599,2.76702239859903,9,26249
4,7172555,PZE-104010129,7174847,PZE-104010147,0.72491106673913,2,2292
4,7436345,PZE-104010326,7448481,PZE-104010351,0.46469697,3,12136
4,9350736,PZE-104010850,9353851,PZE-104010863,0.337756916086957,3,3115
4,9756254,SYN11697,9760095,PZE-104011271,0.38645256826087,3,3841
4,12050310,PZE-104013742,12782818,PUT-163a-74244684-3688,0.795867587478262,10,732508
4,13126554,PZE-104014229,13164849,PZE-104014318,0.62559091,5,38295
4,13771270,PZE-104014546,14036462,PZE-104014780,0.620668643405797,6,265192
4,14507281,SYN12142,14541356,PZE-104015086,0.81886364,3,34075
4,15298119,SYN13983,15583336,SYN33244,0.657008124927537,9,285217
4,15827915,PZE-104016135,16440746,PZE-104016709,0.891632409855073,15,612831
4,17829730,SYN8692,17830683,SYN8693,1.67843873608696,4,953
4,18117835,PZE-104018300,18209282,PZE-104018363,0.44356718913043,5,91447
4,18573717,SYN1501,18916144,PZE-104018885,1.82450498867494,21,342427
4,19859745,PZE-104019303,20118675,PZE-104019481,0.750708168188407,6,258930
4,20736308,SYN24027,21220943,PZE-104019988,0.709466405768115,15,484635
4,22142582,SYN15294,22526835,PZE-104021056,0.787433025507242,9,384253
4,22553686,PZE-104021091,22554719,PZE-104021092,0.24799406978261,2,1033
4,23727148,PZE-104022026,24187210,PZE-104022252,1.17846478901186,11,460062
4,28027491,PZE-104024382,28124580,PUT-163a-76289863-3935,0.374356297826087,7,97089
4,29164960,PZE-104025032,29793985,PUT-163a-78082681-4153,0.552536700155279,14,629025
4,30430665,PZE-104025625,31108073,PZE-104025973,0.764357354114907,28,677408
4,31844172,PZE-104026951,32165780,PZE-104027111,0.451503624855074,6,321608
4,32791915,PZE-104027630,33120348,SYN36961,0.352915015217391,7,328433
4,34019505,SYN5775,34901943,PZE-104028825,0.475790512318843,18,882438
4,35542248,PZE-104029384,35626100,PZE-104029507,0.936201582391307,10,83852
4,35985028,PZE-104029735,36029293,PZE-104029808,0.222356718913045,2,44265
4,37022456,SYN25837,37098309,SYN24109,0.60782608695652,7,75853
4,37570519,PZE-104031236,37762885,PZE-104031302,0.38282361728261,4,192366
4,38022745,PZE-104031374,38067335,PZE-104031472,0.527533595565217,5,44590
4,39542254,PZE-104032365,40354984,SYN32013,0.46771739130435,20,812730
4,40391167,SYN32010,44504375,PZE-104035067,0.484255454221804,69,4113208
4,45266586,PUT-163a-76013805-3742,46166309,PZE-104035707,1.23656126391304,16,899723
4,46169336,SYN18909,56533267,PZE-104041384,1.38835704068702,131,10363931
4,57591728,PZE-104041937,66935940,SYN25538,1.3498936573706,147,9344212
4,79069401,PZE-104050613,81608468,PZE-104051625,0.322591921820022,43,2539067
4,82662652,PZE-104052129,83816571,PZE-104052705,1.24822742397994,26,1153919
4,96309068,PZE-104056726,96311472,PZE-104056745,0.405019762391305,2,2404
4,114281801,SYN8385,119471467,PZE-104060760,1.45100973449276,54,5189666
4,121286070,PZE-104061513,121371052,PZE-104061539,0.321926880652175,2,84982
4,121839521,PZA03376.2,124525538,PZE-104062911,1.7773543951023,34,2686017
4,124642007,PZE-104063005,124930052,PZE-104063146,0.388729002771737,8,288045
4,131108107,PZE-104066247,131193067,PZE-104066292,0.239321476231883,3,84960
4,143073638,PZE-104071903,143716879,PZE-104072466,0.486031903788822,14,643241
4,144669255,PZE-104073328,144727138,PZE-104073340,0.309054678115943,3,57883
4,145622859,SYN19881,150024400,PZE-104076193,0.858210605475737,69,4401541
4,150892554,PZE-104076606,151083374,PZE-104076760,0.72336956521739,6,190820
4,153632998,SYN13967,153752770,PZE-104079495,0.355207512608696,5,119772
4,155771774,PZE-104081298,155805873,SYN29826,1.54985836536232,3,34099
4,156089918,PZE-104081748,156190870,PZE-104081806,0.248809287173915,2,100952
4,156955443,SYN2340,156958698,ZM012531-0288,0.743059942753623,3,3255
4,156993573,SYN9094,156998152,SYN9091,1.2402470373913,4,4579
4,157481981,PZE-104083441,157554508,PZE-104083655,1.11623122547826,5,72527
4,157911888,PZE-104083827,157998574,PZE-104084001,1.03146574318841,3,86686
4,158136346,PZE-104084279,158994747,SYN1832,0.347010373130434,20,858401
4,160111359,SYN4600,160127522,ZM012705-0556,0.362549408478258,4,16163
4,160460480,PZE-104086308,161148001,PZE-104086726,1.69884198857143,21,687521
4,161724042,PZE-104087083,161949049,PZE-104087271,0.257114625869565,2,225007
4,162678166,PZE-104087825,162694715,PZE-104087852,0.386912052608695,2,16549
4,163894752,PZE-104088865,163899358,PZE-104088885,0.368962451956523,4,4606
4,164089735,PZE-104089042,164098248,PZE-104089136,0.554799076521739,3,8513
4,164252250,PZE-104089381,164263863,PZE-104089440,0.418150761242236,7,11613
4,165654835,PZE-104089679,165697854,PZE-104089796,1.15684782708696,10,43019
4,166008071,PZE-104090377,166008973,PZE-104090383,0.544945652173915,2,902
4,166922253,SYN1891,166966261,PZE-104091158,0.52877470173913,4,44008
4,167185622,SYN23101,167186464,SYN23104,1.15752470423913,4,842
4,170013191,PZE-104093478,170027668,SYN2254,0.62215744521739,3,14477
4,170518042,SYN24904,170518204,SYN24901,0.24635375130435,3,162
4,172055122,PZE-104095695,172058969,PZE-104095727,1.37888340239131,2,3847
4,173310967,PZE-104096880,173331938,SYN2088,0.33802371086957,3,20971
4,174850079,PZE-104098283,174912686,SYN2099,0.383602326714978,9,62607
4,175331680,PZE-104098895,175336292,PZE-104098918,1.23007905456522,2,4612
4,175748832,PZE-104099276,175876906,PZE-104099340,0.34925395347826,2,128074
4,176858105,PZE-104099837,176885957,PZE-104099876,0.953250985869565,2,27852
4,179618154,PZE-104103112,179628433,SYN2119,0.560573124347826,4,10279
4,179963889,PZE-104103711,180237417,PZE-104103873,0.350630434782608,5,273528
4,182009253,SYNGENTA6284,182193884,PZE-104106068,1.39695369496895,7,184631
4,183921982,PZE-104107327,183979542,SYN9199,0.56455533869565,4,57560
4,184547096,PZE-104107835,185101282,PZE-104108388,0.942545242974832,19,554186
4,185654787,PZE-104109208,185696404,SYN21456,1.12647233565217,3,41617
4,185726464,PZE-104109431,185763772,PZE-104109566,0.304891304347827,3,37308
4,185868832,PZE-104109689,186199447,PZE-104110016,0.624438551383399,11,330615
4,187876796,SYN1516,188491838,PZE-104113287,0.723352768434781,10,615042
4,189905893,PZE-104114501,190049310,PZE-104114570,1.14731225478261,3,143417
4,191767453,PHM4348.16,191873980,PZE-104116082,0.298007249710147,3,106527
4,192729502,PZE-104116861,192815334,PZE-104116963,0.61128952478261,2,85832
4,193892648,PZE-104117587,195011403,SYN1805,0.507053776270023,19,1118755
4,196977445,SYN34701,197527307,PZE-104120445,0.266472331806019,13,549862
4,198078892,PZA01810.2,198998847,PZE-104122007,0.565409004272213,23,919955
4,199074077,PZE-104122090,199079008,PZE-104122113,0.323745059937888,7,4931
4,199278350,PZE-104122240,199597664,PZE-104122422,0.924141723291926,7,319314
4,199936446,PZE-104122677,200739785,PZE-104123585,0.715327222959864,26,803339
4,201236558,PZE-104123974,202075058,SYN28069,1.27370553086957,18,838500
4,203098232,PZE-104125536,203936765,PZE-104126021,1.37372953198758,14,838533
4,205145277,PZE-104126807,206552423,PZE-104127584,0.778212873519669,21,1407146
4,207531220,PZE-104128050,207859632,PZE-104128161,0.427243083913044,7,328412
4,208099922,PZE-104128326,208594051,PZE-104128500,0.570698757049689,14,494129
4,209798113,SYN6497,209976152,PZE-104129391,1.16369812309783,8,178039
4,211077993,PZE-104130207,211084906,PZE-104130244,0.76826086956522,6,6913
4,216707012,PZB00878.2,216707624,PZB00724.1,0.41349802326087,2,612
4,217522596,SYN492,217923751,PZE-104133975,1.16151186043478,14,401155
4,218321161,PZE-104134275,218846053,SYN4631,0.861294461987576,7,524892
4,219994707,SYN37888,222074857,PZE-104136329,0.959233562260868,55,2080150
4,223107439,SYN37141,223211848,PZE-104136922,0.436679844927537,3,104409
4,224048401,PZE-104137353,224072440,SYN8647,0.43834486347826,2,24039
4,225854988,PZE-104138472,225992853,PZE-104138654,0.47795455,2,137865
4,228627524,SYN17405,228662377,SYN8504,0.25845849347826,4,34853
4,229342112,SYN25721,229344081,PZE-104141018,0.262075099420293,3,1969
4,230192954,SYN29804,230483943,PZE-104141943,0.518114444347826,11,290989
4,230800298,PZA03754.2,230800361,PZA03754.1,0.23672925173913,2,63
4,231403290,PZE-104142854,231406853,PZE-104142839,0.318165348840577,3,3563
4,233005187,SYN11069,233125600,SYN21946,0.404519761391308,5,120413
4,233539118,PZE-104144717,233541810,PZE-104144719,0.68934782608696,2,2692
4,233990079,PZE-104145212,233994679,PZE-104145166,0.247598813623187,3,4600
4,234567498,SYN28905,234571270,PZE-104146305,0.74357707782609,2,3772
4,234713303,SYN19392,234791216,PZE-104146750,0.25926284130435,5,77913
4,235161956,SYN13876,235209943,SYN13870,0.48283596565217,6,47987
4,236569763,ZM004771-0560,236895654,SYN14093,0.691592884739129,10,325891
4,237032134,PUT-163a-31441039-1952,237034276,PZE-104151042,0.368119238260871,3,2142
4,237136783,PZE-104151091,237142280,PZE-104151167,0.84959486347826,2,5497
4,237683341,ZM013346-0450,237704180,PZE-104152618,0.362783269275363,3,20839
4,238362623,SYN7814,238374755,PZE-104154015,0.5061166026087,3,12132
4,238740712,PZE-104154409,238758660,PZE-104154469,0.804043480260874,5,17948
4,239370397,SYN39223,239409709,SYN29052,0.38441501921739,5,39312
4,239682808,PZE-104156296,239702473,SYN21389,1.04974026,7,19665
4,240106598,SYNGENTA0879,240227508,SYN864,0.6379347826087,3,120910
4,240336675,SYN8790,240415965,SYN8787,0.68872859115942,3,79290
4,240522833,PZE-104157783,241322382,PZE-104158108,2.7985424867663,16,799549
5,109141,PZE-105000098,1028227,SYN9873,1.25645539217391,35,919086
5,1319392,PZE-105001477,1341465,SYN21480,0.61828063695652,10,22073
5,1525996,PZE-105001734,1570648,PZE-105002058,0.696202240193235,9,44652
5,1685686,SYN2358,1727484,SYN2371,0.5431733468323,7,41798
5,1898437,SYN14899,1954555,SYN35014,0.21219368043478,9,56118
5,2142037,SYN35353,2142403,SYN35352,1.27083004043478,3,366
5,2259905,PZE-105003682,2268991,PZE-105003736,0.39683300304348,2,9086
5,2283974,PZE-105003938,2308811,SYN33751,0.53194664304348,5,24837
5,3038486,SYN22678,3090863,PZE-105006142,2.53197628913043,13,52377
5,3207080,PUT-163a-60350823-2645,3207115,PUT-163a-60350823-2646,0.227045455,2,35
5,4218967,SYN509,4278609,SYN512,0.7670652173913,12,59642
5,4365864,SYN7885,4424636,PUT-163a-71442496-3334,0.36191699695652,5,58772
5,4578595,PZE-105009954,5200959,PZE-105011856,0.492840084275365,12,622364
5,5379460,SYN12682,6139468,PZE-105014054,0.78384016643116,24,760008
5,6617304,PZE-105015473,6618795,SYN28081,0.28993082913043,2,1491
5,6981475,PZE-105016045,6986417,PZE-105016060,0.50110672391304,3,4942
5,8510156,SYN23467,8549741,PZE-105018859,0.9043379473913,3,39585
5,9662329,SYN33205,9905022,SYN37851,0.40517786252174,5,242693
5,10091198,SYN38234,10101416,PZB00182.1,0.49911067405797,3,10218
5,10317293,PZE-105021734,10438838,PZE-105021925,0.53402667847826,6,121545
5,11345362,PZE-105022646,11345992,PZE-105022648,0.27263833673913,2,630
5,11877562,PZE-105023608,11880075,PZE-105023645,0.992905141521735,2,2513
5,11949525,PZA03678.1,12038114,PZA03092.7,0.228496048521738,5,88589
5,12567838,PUT-163a-91049497-4726,12567844,PUT-163a-91049497-4725,0.23306324565217,2,6
5,13052893,PZE-105025345,13280973,SYN14827,1.01181983144927,6,228080
5,14437375,PZE-105027932,14611522,PZE-105028067,0.684181821000002,10,174147
5,15137526,SYN16500,15435067,PZE-105029444,0.583790231118013,14,297541
5,15800915,SYN16324,15807308,SYN16320,0.376106723913044,4,6393
5,16303939,SYN33294,16320604,PUT-163a-60350211-2639,0.6597529626087,2,16665
5,17066351,SYN10582,17687733,PZE-105031901,0.500399746324114,11,621382
5,20082786,PZB00223.1,20200581,PZA03274.4,0.956726779565217,4,117795
5,21415716,PZE-105036629,21988282,PZE-105036968,0.315816862729467,18,572566
5,22629419,PZE-105037660,22738898,PZE-105037752,0.371697629913043,5,109479
5,23265300,PZA01427.1,23892316,PZE-105039096,1.00007549803478,25,627016
5,25436298,PZE-105040033,25661717,PZE-105040292,0.482153326594203,12,225419
5,28110063,PZE-105041761,28123586,PZE-105041994,0.828152173913045,2,13523
5,31649634,SYN26666,31860788,PZE-105044315,2.67245819551839,13,211154
5,32002482,PZE-105044555,32260329,PZE-105044767,1.02568511289855,3,257847
5,32614798,PZE-105044956,34801447,SYN28933,1.23025691775362,54,2186649
5,36832515,PZE-105047394,39454408,PZE-105048769,2.09736390857049,66,2621893
5,40563942,PZE-105049283,40652459,PZE-105049290,0.427485178623188,6,88517
5,42295067,PZE-105049918,42846769,PZE-105050370,0.762916253387681,24,551702
5,43647639,PZE-105050695,46527761,SYN13547,0.370649134506685,52,2880122
5,46537873,SYN13540,46779865,SYN31657,0.430095518502411,9,241992
5,48144646,PZE-105052646,48384424,PZE-105052784,0.469288535341615,7,239778
5,49897470,PZA02207.1,51435988,SYN6833,0.652492144626532,39,1538518
5,53445250,PZE-105055664,54361153,PZE-105056389,0.652591975551839,13,915903
5,54918757,PZE-105056796,54992598,PZE-105056940,1.12003557130435,5,73841
5,55948775,PZE-105057441,56372660,SYN8932,0.26730039568116,15,423885
5,57204446,PZE-105058689,57210720,PZE-105058702,0.481536562173913,4,6274
5,57376436,PZE-105058752,58526144,SYN1422,0.838945265311909,23,1149708
5,60430176,PZE-105061524,60927378,PZE-105061842,0.544708168521739,15,497202
5,61672051,PZB-001115003,61699962,PZE-105062580,0.407296442869565,5,27911
5,62200260,PZA00710.1,64768821,PZE-105064349,0.934599127229323,51,2568561
5,66031418,PZE-105065011,66110865,PZE-105065076,1.168181815,4,79447
5,66429671,PZE-105065277,66841062,PZE-105065396,1.05691319976589,13,411391
5,67627201,PZE-105065869,68405152,PZE-105066316,1.02555138321739,15,777951
5,69308623,SYN29079,69321172,SYN29090,0.63629446913043,5,12549
5,72613366,PZE-105068951,72613520,PZE-105068954,0.29379446913043,2,154
5,74506945,SYN26103,74507050,SYN26101,0.27727273,2,105
5,76112676,PZE-105071293,77445365,PZE-105072520,0.718561051022327,37,1332689
5,80236358,PZE-105073770,80280742,PZE-105073786,0.320935439855073,3,44384
5,85531944,PZE-105076764,85740267,PZE-105076850,0.416835967652174,5,208323
5,86219837,PZE-105077140,86343387,PZE-105077266,2.11135177956522,5,123550
5,87923755,PZE-105077925,89000253,PZE-105078439,0.832825619875777,21,1076498
5,89317871,PZA03049.23,93700856,PZE-105080933,0.556821548191702,88,4382985
5,103563997,PZE-105084730,127342468,PZE-105090603,1.77026513488625,172,23778471
5,127604425,PZE-105090714,129223679,PZE-105091436,0.959565217391301,25,1619254
5,130690302,PZE-105091942,136200439,PZE-105093758,0.303993864219624,78,5510137
5,139234251,PZE-105094910,142790101,PZE-105096931,1.26847842491525,59,3555850
5,144714036,PZE-105098137,144888602,PZE-105098229,0.605443676434783,10,174566
5,145496429,PZE-105098518,145525514,SYN24229,0.326541501521735,2,29085
5,145867921,PZE-105098804,147707346,PZE-105099535,1.77490308356187,26,1839425
5,148226517,PZE-105099684,148700935,PZE-105099843,0.776137350869565,10,474418
5,149998432,PZE-105100187,150198622,PZE-105100352,0.681520325031055,7,200190
5,155171104,PZE-105102825,155959609,PUT-163a-149014113-778,0.812078533024572,23,788505
5,160165587,PZE-105105462,160531317,PZE-105105590,0.389848483333333,3,365730
5,160711196,PZE-105105740,161281322,PZE-105106024,0.229307717263422,17,570126
5,163409720,PZE-105106949,163412726,SYN33594,0.821776185543475,4,3006
5,163743094,SYN1392,163985401,PZE-105107473,1.59850395547826,5,242307
5,164710608,PZE-105108017,164733011,PZE-105108057,1.16385375380435,4,22403
5,165652829,PZE-105108737,165742446,PZE-105108793,0.85647233231884,6,89617
5,167938830,PZE-105110864,168673145,PUT-163a-18177956-1457,1.27690852569358,21,734315
5,168890197,SYN34468,169668984,PZA03536.1,1.02220355913043,14,778787
5,171049951,PZE-105114143,171711004,PZE-105114903,0.978180294816055,13,661053
5,171964318,SYN36136,172576140,PZA03704.1,1.3982213456917,22,611822
5,173760035,PZE-105116507,174114018,SYN34982,0.408712123333333,3,353983
5,175663600,SYN31802,176909050,PZE-105120292,1.41672202074231,41,1245450
5,177230504,SYN32464,179150092,PZE-105122136,0.905677952249526,46,1919588
5,179928870,SYN9631,180440398,PZE-105123697,1.56139637005435,16,511528
5,181588001,PZE-105124618,182250120,PZE-105125202,0.859757905170808,28,662119
5,183149204,SYN1146,183321037,PUT-163a-149076210-846,1.71731225103261,8,171833
5,184161821,PZE-105126747,184234139,PZE-105127132,0.564630434782608,5,72318
5,184336676,PZE-105127228,184353254,PZE-105127386,0.666805005072463,3,16578
5,185570018,PZE-105128217,185666322,PZE-105128589,0.687682255942028,9,96304
5,186507337,PZE-105129247,186507410,PZE-105129248,0.238330040434785,2,73
5,186735620,PZE-105129571,187200869,PZE-105130670,1.2359616426087,22,465249
5,187569950,PZE-105130786,187662469,PZE-105130833,0.609781511062803,9,92519
5,188389770,PZE-105131134,188389851,PZE-105131137,0.214604742173915,2,81
5,188463119,SYN16488,188467017,SYN16484,0.646413040978262,4,3898
5,188829673,PZE-105132211,188834472,SYN35856,0.564907775507247,3,4799
5,188917817,PZE-105132581,189866304,PZE-105133450,0.891945227991718,21,948487
5,190198831,PZE-105133858,190211048,PUT-163a-16926285-1144,0.27759881195652,2,12217
5,190481770,SYN14521,190612421,PZE-105134501,0.30599802826087,8,130651
5,190865864,SYN38255,191033131,PZE-105134993,0.729930829130435,5,167267
5,191205506,PZE-105135342,191247078,PZE-105135428,1.04558497878261,5,41572
5,191749738,PZE-105136341,191892906,PUT-163a-4314538-2046,0.681432810869565,5,143168
5,192179546,PZE-105136959,192376681,PZE-105137497,0.912026926195654,8,197135
5,192526658,PZE-105137712,192998952,PZE-105137942,1.78487153695652,12,472294
5,193416122,PZE-105138095,193937085,PZE-105138941,0.517799210104351,25,520963
5,195443613,SYN1176,195664709,PZE-105141007,0.512484473478263,7,221096
5,196023222,SYNGENTA5631,196177961,SYN31099,1.21256505224638,12,154739
5,196787901,SYN28488,197788438,PZE-105143481,0.947899489648031,21,1000537
5,198042302,PZE-105144179,198044880,PZE-105144193,0.491887350869565,2,2578
5,198526942,PZE-105144626,198716544,PZE-105144767,1.41482871927536,3,189602
5,199643263,PZE-105146456,199647442,PZE-105146513,0.36533102880435,4,4179
5,200649357,SYN11897,200877505,PZE-105148878,0.39746047521739,9,228148
5,202519090,PZE-105151403,202827019,PZE-105151612,0.344328058695652,8,307929
5,203405146,PZE-105152305,203407056,PZE-105152296,0.437732214347826,4,1910
5,206263616,PZE-105158473,206272652,PZE-105158503,1.21867588978261,2,9036
5,206557530,PZE-105158756,206563089,PZE-105158804,0.36126482304348,2,5559
5,208263077,PZE-105163425,208266767,PZE-105163435,0.475864625869565,2,3690
5,209255165,PZE-105165545,209471231,SYNGENTA13567,0.409494400072464,6,216066
5,210022600,PZE-105166634,210022668,PZE-105166637,0.32490118304348,2,68
5,210691247,SYN29192,210752365,SYN28270,0.56502964608696,5,61118
5,211281947,SYN3905,211520011,SYN2631,1.63287055108696,8,238064
5,211939086,SYN18055,211939303,SYN18041,0.28761857434783,2,217
5,212164824,PZE-105171747,212173812,SYN5747,0.279397229565217,11,8988
5,212219725,PZE-105171961,212319875,SYN38866,1.18340909,6,100150
5,212748047,SYN35259,212819118,SYN35279,0.966309667892977,13,71071
5,213035224,SYN9177,213037073,SYN9171,0.6304347826087,2,1849
5,213291931,SYN2950,213301427,SYN2927,1.944015152,15,9496
5,213726718,SYN25263,213726940,SYN25255,1.18012846304348,2,222
5,214283378,SYN33429,214284853,SYNGENTA12447,0.44439723289855,3,1475
5,214376946,SYN33425,214382086,PUT-163a-71427540-3259,0.6833893326087,3,5140
5,214517424,PZE-105178018,214622731,ZM005841-0400,0.463738469855073,3,105307
5,215622830,SYN33323,215626737,SYN33329,1.01350790695652,6,3907
5,215991421,PZE-105181352,216164529,PUT-163a-71328889-3180,0.2854743073913,12,173108
5,216439893,SYNGENTA14200,216440431,SYNGENTA14197,1.07420948684782,4,538
5,216533976,PUT-163a-16927090-1168,216546720,PZE-105181926,0.336556324565218,4,12744
5,216644366,PZE-105182082,217708600,PZE-105182676,0.333368837165859,27,1064234
6,129643,PZE-106000007,680353,PZE-106000314,0.399706852028983,24,550710
6,1234387,PZE-106000504,1240386,PZE-106000516,0.878552373586955,4,5999
6,2882514,SYN22071,3988173,SYN13485,1.11053853491304,30,1105659
6,4607882,PZE-106003733,4802276,PUT-163a-149095867-899,0.984213437826085,5,194394
6,4885267,PZE-106003958,5445335,PZE-106004307,0.558079202775921,13,560068
6,6259596,PZE-106004952,6268139,PUT-163a-94473612-4864,0.47711709554348,4,8543
6,6432788,SYN22733,8108778,SYN27273,0.606219367043479,10,1675990
6,9490668,PZE-106007051,18991117,PZE-106021420,1.61102245612648,55,9500449
6,20331355,PZE-106021644,21185064,PZE-106007308,0.46427667747826,5,853709
6,22664410,PZE-106007763,25581860,PZE-106008914,0.3858346387931,58,2917450
6,26561158,PZE-106009223,27502938,PZE-106009689,0.482905135688405,24,941780
6,27899230,PZE-106009925,27904433,PZE-106009923,0.337835970652175,2,5203
6,28144832,SYN36834,28767888,PZE-106010463,0.614352061242239,7,623056
6,32456515,PZE-106012720,34443143,PZE-106013427,0.633210861014494,33,1986628
6,34537527,SYN20528,34603600,PZE-106013540,0.32389327608696,6,66073
6,34978226,SYN17206,35091333,SYN26542,0.26942687565217,11,113107
6,35895383,PZE-106014445,35896206,PZA03063.21,0.367450596521739,5,823
6,39079387,PZE-106016518,46775470,PZE-106019347,0.432080597010306,97,7696083
6,47845187,PZE-106019546,58456095,PZE-106024353,0.828603395984912,98,10610908
6,59107964,PZE-106024716,65269257,PZE-106027275,0.2686561273913,94,6161293
6,72850864,PZE-106031058,72860546,PZE-106031110,0.819884718550727,3,9682
6,78735781,SYN2644,78820609,SYN11613,1.59187747217391,4,84828
6,79195608,PZE-106033899,80190869,SYN24725,0.912880252769726,27,995261
6,82016007,PZE-106035097,82701408,PZE-106035421,0.631480415494071,11,685401
6,83228582,PZE-106035842,83616120,PZE-106036054,0.281616845326088,8,387538
6,84051369,PZE-106036364,84676427,PZE-106036904,0.452735634280936,13,625058
6,85410480,PZE-106037346,85517575,PZE-106037482,0.51727273,2,107095
6,86023895,PZE-106037761,86476196,PZE-106038326,0.412120270124224,14,452301
6,88564187,PZE-106039739,88911293,PZE-106040387,0.780777886763285,18,347106
6,88998636,PUT-163a-21390480-1528,89065990,PZE-106040697,0.538596841884057,3,67354
6,91643101,PZE-106042198,92396681,SYN11566,0.634878728735178,11,753580
6,93229752,PZE-106043354,93328165,SYN2958,0.590718048550727,3,98413
6,93877213,PZE-106044734,94426320,PZE-106045024,0.782790953816427,9,549107
6,94502702,PZE-106045064,94518559,PZE-106045095,0.30294137173913,3,15857
6,94714065,PZE-106045280,94844621,PZE-106045624,0.41397562521739,3,130556
6,95472950,SYN3678,95476531,SYN3677,0.316581027971015,3,3581
6,97339612,PZE-106048351,97634269,SYN3491,0.609066203260867,12,294657
6,98257387,PZE-106049277,98257427,PZE-106049278,0.78406126391304,2,40
6,100200639,PZE-106050388,100214304,PZE-106050426,0.49037549543478,2,13665
6,103857861,SYN4597,104113156,PZE-106053653,0.369554101358694,8,255295
6,104859110,PZE-106054182,104865093,PZE-106054189,0.411551385217393,3,5983
6,105045847,PZE-106054425,105075088,PZE-106054468,0.280971671739133,3,29241
6,105926744,PZE-106055606,105952893,SYNGENTA2097,0.30425889782609,2,26149
6,107270445,PZE-106056673,110152982,PZE-106059851,1.03313253637681,78,2882537
6,111678034,PZE-106057769,111707039,PZE-106057860,0.550256916086957,3,29005
6,112349791,SYN30628,112596521,SYN28805,1.01996316758893,11,246730
6,113558165,PZA00182.4,113559709,PUT-163a-76915921-4006,0.23179347826087,2,1544
6,114178400,PZE-106062990,114185516,PZE-106063009,1.62421442869565,4,7116
6,114481013,PZE-106063139,115755136,PZE-106064205,0.478992414614305,31,1274123
6,116024727,PZE-106064381,116895858,PZE-106064885,0.48249012130435,14,871131
6,119121574,SYN34809,120933896,SYN15752,0.878119235483089,36,1812322
6,123372713,SYN26938,123373109,SYN26945,0.277796440869565,4,396
6,123729914,SYN3455,123730103,SYN3451,0.43478260869565,2,189
6,124531652,SYN7542,124709894,SYN32940,3.82549407478261,10,178242
6,129139474,PZE-106073551,129272650,PZE-106073623,0.7768749975,4,133176
6,129471538,SYN24366,129473249,SYN24361,0.95346838217391,4,1711
6,129980213,PZE-106074780,129981085,PZE-106074800,0.228275692608695,2,872
6,130586557,PZE-106075377,131411390,PZE-106076029,2.75106360051383,22,824833
6,132431129,PZE-106077036,132431872,PZE-106077040,0.997999009130435,2,743
6,132889427,PZA00250.1,133514256,PZE-106078099,1.00708725909699,26,624829
6,133816320,PZE-106078323,138187940,SYN15161,1.78790046941107,110,4371620
6,138930012,PZE-106081873,139620998,PZE-106082466,0.734271705024155,27,690986
6,140778098,PZE-106083373,142257034,PZE-106084877,0.507863580242968,34,1478936
6,142347038,SYN26383,142454412,PZE-106085217,0.8315711426087,5,107374
6,142950378,PZE-106085963,143955268,SYN22021,0.836215419565217,24,1004890
6,143962014,PZE-106086588,144706446,PZE-106087191,0.571114315986622,26,744432
6,145987264,PUT-163a-4730530-2148,146121096,PZE-106088503,0.370474307391304,7,133832
6,147137823,SYN27107,147209782,SYN28457,0.54087944391304,5,71959
6,147910200,SYN29380,147925421,SYN29384,0.22360672391304,16,15221
6,148426848,PZE-106092279,148530193,PZE-106092387,0.492272727999996,5,103345
6,149358067,PZE-106093877,150074555,SYN29969,0.587782493299235,17,716488
6,150308567,PZE-106095147,150688349,SYN4789,0.566605316014491,24,379782
6,150737685,SYN11816,150742529,SYN11824,0.48243082913043,2,4844
6,150889413,PZE-106096872,150891314,PZE-106096901,0.68559288173913,5,1901
6,151795404,SYN26322,151872752,PZE-106098066,0.687764327608692,4,77348
6,153655457,PZE-106100910,153665962,PZE-106101046,1.97793478260869,3,10505
6,154165245,SYN24459,154237741,SYN24465,1.28345849347826,7,72496
6,154326722,PZE-106102395,154782129,PUT-163a-28985344-1712,0.527894497926421,13,455407
6,155508945,SYN23855,155524834,SYNGENTA12830,0.655073404596274,7,15889
6,155757023,PUT-163a-71422538-3211,156692942,PZE-106106877,1.4856528552024,29,935919
6,156820261,SYN23621,156827327,SYN23623,1.88166995956522,3,7066
6,157324459,PZE-106108115,157564961,SYN14798,0.50619565217391,10,240502
6,158259287,SYN19164,158282194,SYN19158,2.08916008086957,7,22907
6,158366537,PZE-106109825,158369685,PZE-106109857,0.49212121,3,3148
6,159147552,SYN26097,159151310,ZM012369-0391,0.42454545,3,3758
6,159616948,PZE-106112096,159825367,SYN27128,0.590339260217392,12,208419
6,161446901,PUT-163a-71303230-3078,161465353,PZE-106115403,0.295360672391303,6,18452
6,161874523,PZE-106116583,162015103,SYN9304,1.14804347937198,9,140580
6,162479406,SYN32558,162547527,SYN24534,1.01403161782609,6,68121
6,162643617,PZE-106119113,162645229,SYN24539,0.41964426695652,7,1612
6,162686012,SYN22993,162689129,SYN22992,1.41583004043478,3,3117
6,163011289,PUT-163a-78074902-4096,163178535,SYN34377,0.551667487391307,12,167246
6,164645749,PZE-106123709,164658172,PZE-106123780,0.634955535869565,2,12423
6,164891527,PZA02141.1,164901150,SYN10683,1.27963438826087,4,9623
6,165247443,SYN4311,165317744,SYNGENTA10901,0.43505929217391,10,70301
6,166053621,SYN18593,166054160,SYN18594,0.82023715869565,2,539
6,166254385,SYN7863,166471175,PZE-106128325,0.742575100086958,5,216790
6,167018795,PHM5529.4,167824948,SYN35817,0.782332675086956,30,806153
6,167982389,PZE-106130505,168979046,PZE-106129904,0.380132989945653,24,996657
7,726534,PZE-107000453,729175,PZE-107000687,0.81189722956522,2,2641
7,908829,PZA01426.1,911318,PZE-107000362,0.396833003043475,2,2489
7,1138277,PZE-107000992,1226773,PZE-107001156,1.52571640460145,12,88496
7,1297354,SYN10738,1310254,PUT-163a-60347260-2574,0.55166008086957,10,12900
7,1972892,SYN36193,1975989,PZE-107002330,1.24385869565217,2,3097
7,2133651,PZE-107002578,2135320,SYN24975,0.60395256826087,3,1669
7,2582409,SYNGENTA14859,2616628,PZE-107003481,0.768858694652174,10,34219
7,2963677,SYN24439,3000255,PZE-107004578,0.241600792028987,3,36578
7,3073422,PZE-107004741,3074900,PZE-107004786,0.508814231521735,2,1478
7,3194227,PZE-107004995,3588989,PZE-107005360,0.284084320869563,3,394762
7,3663038,PZE-107005392,3824391,PZE-107005556,0.748280631400968,9,161353
7,4703474,SYN37963,4795874,SYN37961,1.12321146608696,3,92400
7,4957394,PZE-107007133,4958776,SYN21560,0.473745060652175,2,1382
7,5797588,PZE-107008960,5978305,PZE-107009208,0.463359681521735,2,180717
7,6127634,PZE-107009409,6550521,PZE-107010082,0.642674573623185,6,422887
7,7410318,SYN19831,7524272,PZE-107011169,0.523227424749163,13,113954
7,8057494,SYN4536,8309270,SYN24999,0.67813369982987,23,251776
7,8701128,SYNGENTA6494,8929809,PZE-107012310,1.98848937815217,8,228681
7,9200061,SYN18116,9200919,PZE-107012564,0.382707512608695,2,858
7,9329135,SYN36572,9329883,SYN36579,0.430662057608695,2,748
7,9330613,SYN36577,9330622,SYN36576,0.46005928717391,2,9
7,9590220,PZE-107013297,9591191,SYN34667,0.22546936804348,2,971
7,10288416,SYN24605,10549337,SYN19318,1.7352075126087,4,260921
7,13406428,PZE-107015950,13407624,PZE-107015958,1.38306983144928,3,1196
7,14886758,PZE-107017355,15282338,SYN35761,1.26366542498721,17,395580
7,15416447,PZE-107017855,17143015,PZE-107018798,0.503402417367805,37,1726568
7,17470930,SYN15993,17697607,SYN27394,0.723544738458497,11,226677
7,18426957,SYN26797,18610559,PZE-107019984,0.231810772228259,8,183602
7,21151167,SYN5037,21331332,SYN28353,1.90700592521739,16,180165
7,21869640,PZE-107022242,23960276,SYN37641,0.732419450026353,33,2090636
7,26958269,PZE-107024830,27213546,PZE-107025027,1.74986056173913,9,255277
7,27420345,PZE-107025209,27480166,PZE-107025223,0.50564229521739,2,59821
7,29053955,PZE-107026046,29560271,PZE-107026444,1.17168873358696,20,506316
7,30156469,PZE-107026608,33056295,PZE-107027813,1.01042490391304,68,2899826
7,33095257,SYN13909,36725971,PZE-107029600,1.13849366156409,77,3630714
7,37252556,PZE-107029827,39506033,PZE-107030605,3.08775414805217,25,2253477
7,41490888,PZE-107031924,41539367,SYN17364,0.567840905,2,48479
7,43421550,PZE-107032582,44389799,PZE-107032987,1.39869377004141,21,968249
7,45117728,PZE-107033224,76397898,PZE-107039440,2.72219100353282,255,31280170
7,76579953,PUT-163a-18171884-1372,79560286,PZE-107040678,0.709889614326617,41,2980333
7,79560669,PZE-107040681,84176300,PZE-107042710,0.977164812974462,63,4615631
7,84488991,PZE-107042891,84503745,PZE-107042903,0.26466403101449,3,14754
7,84702418,SYN29842,85882473,PZA02291.1,0.930984735532231,29,1180055
7,86018931,PZE-107043608,92335869,PZE-107045210,1.3662161633902,79,6316938
7,99541472,PZE-107050350,99955636,PZE-107050536,0.804610232560388,9,414164
7,100622093,PZE-107051266,101259886,PZE-107051602,2.39702305828986,15,637793
7,102568743,PZE-107052313,103666932,PZE-107052775,0.782599395115089,17,1098189
7,105067196,PZE-107053815,105695191,PZE-107054422,0.660859683913044,23,627995
7,106326475,PZE-107054656,107394379,PZE-107055578,0.823599388106592,31,1067904
7,107928376,SYN16556,108482809,PZE-107056322,0.639161122311212,19,554433
7,109054487,PZE-107056842,109056890,PZE-107056833,0.25541995956522,2,2403
7,115181654,PZE-107059690,116382412,PZE-107060650,1.9086273814888,33,1200758
7,117518072,PZE-107061306,117519226,PZE-107061311,0.475899206304345,2,1154
7,118623967,SYN3200,119255159,PZE-107062740,1.58628458043478,8,631192
7,120352276,PZE-107063187,121192888,PZE-107064021,0.29723131927536,21,840612
7,121252990,PZE-107064289,121316500,SYN38588,1.0045256926087,6,63510
7,121574874,SYN13239,122449305,PZE-107065621,1.78323554790761,16,874431
7,122714403,PZE-107065946,123589752,PZE-107066519,0.643691584475702,17,875349
7,124122246,PZE-107067237,124144853,PZE-107067262,0.64664031347826,2,22607
7,125103412,PZB01186.3,125404626,PZE-107068730,0.842710802173913,9,301214
7,125858346,PZE-107068924,126642071,PZE-107069959,1.23288497718261,25,783725
7,127590835,SYN20393,127608827,PZE-107071389,0.24955533869565,3,17992
7,128121229,PZA00370.1,128146116,PZE-107072030,0.813461793043476,9,24887
7,128708330,PZE-107072410,129265357,PZE-107072681,0.591419886421402,13,557027
7,129967283,SYN28758,129970180,SYN28756,1.50353755304348,4,2897
7,131038051,PZE-107075734,131126598,PZE-107075904,1.05082806469565,5,88547
7,131436957,PZE-107076252,132072680,SYN29954,0.694737593526568,9,635723
7,132157598,PZE-107076827,132164876,SYN29953,0.22765809913043,7,7278
7,132591806,PZE-107077474,132733420,PZE-107077795,0.32393527554348,4,141614
7,133624271,PZE-107078770,133870613,PZE-107078834,0.34174900913043,3,246342
7,134008946,SYN8219,134038950,SYN8213,1.4734288573913,4,30004
7,134086753,SYN22397,134137901,PZE-107079652,0.70992095043478,9,51148
7,134708177,PZE-107079956,134878269,PZE-107079997,0.583027666347826,5,170092
7,136442729,PZE-107082043,137279315,PZE-107081437,1.18671472071611,17,836586
7,138016056,PZE-107080702,139602620,PZA00740.3,0.805417359908465,38,1586564
7,141638448,SYN6951,141646348,SYNGENTA10581,0.557252960942029,6,7900
7,141676398,SYN6941,141905228,SYN22160,2.03652173913043,18,228830
7,142775448,PZE-107087392,142813643,PUT-163a-18179199-1481,0.211116599275363,9,38195
7,143203880,PZA03258.2,143208018,PZA-003166001,0.25786561673913,2,4138
7,144243568,PZE-107089278,145728849,SYN16900,0.344360450253622,36,1485281
7,145743412,PZE-107090737,147588602,SYN2629,0.813719336116942,58,1845190
7,147709732,PZE-107093165,150009618,PZE-107094672,1.16735215663044,52,2299886
7,152443839,PZE-107097026,152777362,SYN5205,0.96669192,9,333523
7,152824375,SYN34174,153253967,PZE-107098089,0.367661394528985,12,429592
7,153294455,PZE-107098163,153709711,PZE-107098667,0.30807851363636,11,415256
7,154179180,PZE-107099124,154456657,PUT-163a-13198758-193,0.29286560873913,10,277477
7,154702691,PZE-107100050,155703825,PZE-107101504,0.617252004670403,31,1001134
7,155964847,SYN19064,156023967,PZE-107102135,0.610086463586958,4,59120
7,156501153,SYN10135,156668777,PZE-107103294,2.05099308641304,8,167624
7,159759568,PZE-107108200,160028651,SYN29620,0.53569053531969,17,269083
7,160082017,PZE-107109140,160289557,SYN23137,1.13823642489702,19,207540
7,160835533,PZE-107110794,160999761,PZE-107110888,0.350923913043475,2,164228
7,162084588,PZE-107113337,162086918,PZE-107113353,0.396245058985507,3,2330
7,164071283,PZE-107116723,164075654,SYNGENTA14901,0.38716403434783,4,4371
7,164987683,SYN23691,165033000,SYN33698,0.24675889782609,4,45317
7,165375694,PZE-107119102,165385956,PZE-107119135,0.58620553086957,3,10262
7,166370636,PZE-107120907,166565966,PZE-107121307,0.480732640434782,14,195330
7,167715777,PZE-107123571,167987505,SYN12253,1.31124258847826,4,271728
7,168090539,SYNGENTA6303,168201559,SYN3263,0.467795032484469,7,111020
7,168404328,SYN34052,168467680,SYN34051,0.32058300304348,5,63352
7,168683334,SYNGENTA5469,168683763,SYNGENTA5470,0.280556653188403,3,429
7,169094842,PUT-163a-60399196-2989,169204328,SYN17015,0.898917981159425,6,109486
7,169749336,PZE-107127258,169925143,SYN25200,0.678640317478262,5,175807
7,170113992,PUT-163a-60394076-2895,170387842,PZE-107128011,0.591574442173913,3,273850
7,170642744,PZE-107128534,170653770,PZE-107128632,0.24914031847826,2,11026
7,170818486,PZE-107128845,170962003,PZB02448.2,0.360945321884059,3,143517
7,172113929,PZE-107130986,172114568,PZE-107131010,0.446936759347825,2,639
7,172158108,PZE-107131127,172207610,SYNGENTA5289,0.548915019217392,5,49502
7,174339964,SYN34651,174359522,PUT-163a-60398021-2968,0.391630434782609,4,19558
7,174506330,PUT-163a-148942056-449,174537456,PZE-107136629,0.800434785108698,4,31126
7,174864155,PZE-107137157,174864319,PZE-107137158,0.90231225478261,2,164
7,175209177,SYN18618,175349338,PZE-107137764,0.34691205594203,6,140161
8,98468,PZE-108000086,407907,PZE-108000136,0.741729867282605,16,309439
8,774782,PZE-108000664,834322,PZE-108000731,0.457231553768116,6,59540
8,1831104,SYN10053,2059200,SYN15865,0.75195652173913,8,228096
8,2154661,PZE-108002149,2297367,PZE-108002202,0.377608695652174,4,142706
8,2512300,PZE-108002411,2516825,PUT-163a-60337233-2343,0.430543481594203,3,4525
8,2870279,PZE-108002742,2901121,PZE-108002818,0.57421936804348,2,30842
8,4234473,SYN27445,4234974,SYN27444,0.97766798782609,2,501
8,4467681,PZE-108004477,4515790,SYN3176,0.996867593478261,6,48109
8,4958525,PZE-108004841,4959906,PZE-108004843,0.78051383217391,2,1381
8,5894265,PUT-163a-71445680-3381,5894383,PUT-163a-71445680-3382,0.83487153695652,2,118
8,6023323,SYN3883,6104741,PZE-108006031,1.00632411521739,6,81418
8,6584683,SYN10427,6592041,SYN10432,0.30550395347826,4,7358
8,7039437,PZE-108007013,7617692,SYN9903,0.499847824086956,5,578255
8,8731594,PZE-108008825,8858054,SYN18177,0.319998024260868,5,126460
8,10760848,PZE-108010180,10862428,SYN36560,0.403583003043478,5,101580
8,12903707,SYN36538,12989194,PZE-108012841,0.30406126724638,3,85487
8,13912154,SYN18494,14593507,SYN7798,0.969695418439896,17,681353
8,14778018,PZA02955.3,15778470,SYN34900,1.09533909050344,19,1000452
8,16442995,SYN23097,16917256,SYN4087,0.43493083246377,9,474261
8,17301677,PZE-108018114,17304758,PZE-108018140,0.395293147971017,3,3081
8,17391613,PZB01977.7,17392146,PZB01977.1,0.384423582753627,3,533
8,17945679,PZE-108019790,18350813,PZE-108019174,0.21102766434783,11,405134
8,19510543,PZE-108020370,20309416,PZE-108021296,0.416705462286633,27,798873
8,22173115,SYN35861,22392417,PHM6428.11,0.45670948434783,6,219302
8,22676233,SYN3488,22681697,SYN3485,0.74306324565217,3,5464
8,23418408,SYNGENTA16759,23424735,PZE-108024691,0.683339919130435,3,6327
8,23961095,SYN15118,23988429,PZE-108025294,0.91540513652174,2,27334
8,26583799,PZE-108028788,33452065,PZE-108030050,0.562618029142515,72,6868266
8,35815240,PZE-108031355,37640027,PZE-108032269,2.65068409700669,26,1824787
8,37784744,PZE-108032449,37810935,PZE-108032490,0.271656127391304,5,26191
8,43075044,PZE-108034353,44012573,PZE-108034619,0.409401185043478,10,937529
8,45262014,PZA00417.3,55514465,PZE-108036269,1.13235855170493,89,10252451
8,55711353,PZE-108036299,62555003,SYN19535,1.20921417564778,99,6843650
8,62557190,SYN19534,63145783,PZE-108038623,2.20471053173913,17,588593
8,65972918,PZE-108040469,67381346,PZE-108041370,0.398074111217391,20,1408428
8,70102303,PZE-108042489,70136052,PZE-108042470,0.219451582391304,2,33749
8,71977160,SYN12524,71988681,PZE-108043299,0.22533596565217,3,11521
8,72384004,PZE-108043501,72653510,PZE-108043749,0.277544464130438,4,269506
8,73895797,PZE-108044406,75303538,PZE-108045495,0.500979725861514,27,1407741
8,75646966,PZE-108045901,79074879,PUT-163a-71307175-3090,1.73759587234431,74,3427913
8,79280537,PZE-108047286,82560840,PZE-108048611,1.59373948382385,39,3280303
8,85864192,PZE-108049642,86959998,PZE-108050089,0.489230009331108,13,1095806
8,87031101,PZE-108050049,89002572,PZE-108050864,1.10308517348887,41,1971471
8,91386309,PZE-108051785,91424222,PZE-108051799,0.336814890434783,3,37913
8,91844636,PZE-108051972,91873848,PZE-108051997,0.558323451304347,3,29212
8,94513906,PZE-108052947,94696672,PZE-108053103,0.635584651159422,6,182766
8,95580373,PZE-108053588,96076158,SYN3403,0.620719861978264,20,495785
8,98995088,PZE-108055133,99280801,PZE-108055317,1.49196488217391,13,285713
8,99969884,PZE-108055572,99970124,PZE-108055575,1.06364624869565,2,240
8,102263567,PUT-163a-74239932-3645,103192437,SYN21444,1.07520186097309,21,928870
8,104462824,PZE-108058477,104463029,PZE-108058478,0.372504939347825,2,205
8,104819451,PZE-108058764,105132722,PZE-108058939,0.490283269275367,3,313271
8,106237050,PZE-108059457,106282153,SYN16948,0.221971344782607,6,45103
8,106743096,PZE-108059739,109672709,PZE-108061148,0.572725595983788,59,2929613
8,110182289,PZE-108061500,110182811,PZE-108061507,1.02857213347826,2,522
8,110372621,PZE-108061670,110377944,PZE-108061693,0.46823122847826,2,5323
8,110988391,PZE-108062079,111048758,PZE-108062040,0.85083991913043,7,60367
8,111196475,PZE-108062273,111825538,PZE-108062578,0.655230564565216,12,629063
8,112311645,PZE-108062772,115406857,PZE-108064616,1.5120984952046,68,3095212
8,115905681,PZE-108064845,115907321,PZE-108064857,0.389545455,2,1640
8,117437378,SYN27030,117572654,SYN37439,0.39220355913043,3,135276
8,118401344,SYNGENTA14910,118787645,PZE-108067060,0.797538116397516,14,386301
8,119041845,PZA03509.1,119151487,PZE-108067429,0.37312676440994,7,109642
8,119583922,PZE-108067816,119744064,PZE-108067922,0.428636363333333,6,160142
8,119831544,SYN13438,119832610,PZA03637.3,0.20607707782609,3,1066
8,120056657,PZE-108068275,120875063,SYN12976,0.624079791467391,16,818406
8,121887169,PZE-108069336,121895631,PZE-108069428,0.83389822043478,2,8462
8,121902511,PZE-108069440,122929113,SYN35000,0.408605620724638,27,1026602
8,123005279,PZE-108070106,123056834,PZE-108070194,0.33265809913043,3,51555
8,123601086,PZE-108070588,124357232,PZE-108071079,0.586129179130435,11,756146
8,124645156,PZE-108071457,124657474,PZE-108071598,0.255597826086957,4,12318
8,124792740,PZE-108071654,125198458,PZE-108072188,0.596090076109837,19,405718
8,125473101,PZE-108072485,126080719,PZE-108072703,0.794330343779264,13,607618
8,128250549,SYN34036,128603188,PZE-108073672,1.4459216701581,11,352639
8,128973724,PZE-108073899,129135133,SYN30027,0.692717391304348,6,161409
8,129291444,SYN25246,131113149,PZE-108075552,0.53263545711957,48,1821705
8,131584062,PZE-108076252,132003545,SYNGENTA17044,0.467587284033818,18,419483
8,132877586,PZE-108077348,133034210,PZE-108077447,0.40106917286957,5,156624
8,133179660,SYNGENTA0179,133278234,PZE-108077705,0.748913045144927,6,98574
8,133439049,PZE-108077786,133562520,PZE-108077879,2.00578063695652,7,123471
8,136415654,SYN27894,138303037,PZE-108081419,1.83039657209662,45,1887383
8,138390683,PZE-108081468,138795042,SYN7980,0.819750885514874,19,404359
8,138910229,PZE-108082144,138910476,PZE-108082156,0.74463438826087,2,247
8,140094813,PZE-108083275,140097654,PZE-108083286,1.31911561673913,2,2841
8,140460935,SYN3892,140582513,PZE-108083725,1.12721626031056,7,121578
8,141137431,PZE-108084007,141210551,PZE-108084055,0.45823451637681,3,73120
8,142294302,PUT-163a-16925878-1123,142294715,SYN12257,0.33705533869565,3,413
8,142668186,PZA03608.2,142668864,PZE-108085728,1.99836956521739,2,678
8,143367589,PZE-108086277,143463648,PZE-108086333,0.422867589478261,5,96059
8,144021136,PZE-108086642,144487236,PZE-108086779,0.772385374130435,10,466100
8,144699942,PZE-108087067,144732487,PZE-108087165,0.52033926521739,3,32545
8,145472295,PZE-108087997,145842587,PZA-000429001,1.06736683567288,21,370292
8,146603562,PZE-108089600,146624390,PZE-108089715,0.530392783152173,4,20828
8,148078863,PZA00686.8,148092310,PZE-108090837,0.235928852391305,2,13447
8,148515313,PZE-108091371,148676361,PZE-108091532,0.722559288173914,5,161048
8,149148239,PZE-108092117,149304728,PZE-108092331,0.27335968652174,3,156489
8,150562764,PZE-108093748,150569694,PZE-108093787,0.395484191086955,2,6930
8,150870128,ZM013780-0381,151664624,PZE-108095270,0.911230451493384,23,794496
8,152323044,PZE-108095959,152438836,PZE-108096042,1.35322924973913,5,115792
8,153016739,PZE-108097250,153139646,PZE-108097482,1.9650510515942,6,122907
8,154528798,PZE-108098268,154530603,PZE-108098273,0.502178852391305,2,1805
8,155029958,PZE-108098682,155051934,PZE-108098736,0.676225298260865,2,21976
8,155590962,PZE-108099332,155653331,PZE-108099484,1.03185573504348,5,62369
8,155905826,PZE-108099631,155979665,PZE-108099840,0.86118906637681,3,73839
8,156350132,PZE-108100275,156476235,PZE-108100559,0.613290512318838,6,126103
8,156868101,PUT-163a-149086978-883,156921338,PZE-108100984,0.526895436166009,11,53237
8,157670638,PZE-108101966,157989796,PZE-108102648,1.96242588878261,10,319158
8,158442874,PZE-108102902,158578821,PZE-108102994,2.03450790495652,5,135947
8,158984163,PZE-108103193,159014083,PZE-108103365,0.567537057608698,4,29920
8,159983807,PZE-108105381,160401941,PZE-108106293,0.514685440688406,12,418134
8,161635677,PZE-108108010,161766769,SYN4196,0.65937747217391,4,131092
8,161838267,SYN9929,162185412,PZE-108108690,0.775423492670807,14,347145
8,162832884,SYN13353,163003112,PZE-108110136,0.776507619565217,7,170228
8,163115932,PZA03593.1,163741671,SYN17500,1.44964202043478,22,625739
8,164898780,SYN30183,164900194,PZE-108113587,1.83238142565217,3,1414
8,164933138,SYN30178,165153091,PZE-108113902,0.384051385217391,10,219953
8,165268442,SYN32177,165282237,PZE-108114666,0.578690712826085,2,13795
8,165681725,SYN9752,166484147,SYN12100,0.864206580613811,17,802422
8,166672371,SYN31086,166676070,SYN31082,1.87987153695652,2,3699
8,167086643,PZE-108118398,167125559,ZM013712-0391,0.460697625913044,5,38916
8,167782275,SYN26309,168275373,PZE-108120405,0.495620879710143,12,493098
8,169013325,SYN36468,169061535,PUT-163a-148963909-609,0.60416995956522,4,48210
8,169126225,SYN25129,169127002,SYN25130,1.28000987869565,2,777
8,169624649,SYN21885,169792196,SYN34539,0.434462697173913,8,167547
8,171302381,PZA00189.23,171565941,PUT-163a-93015241-4826,0.39990118304348,18,263560
8,172223355,PUT-163a-37416849-2023,172351557,SYN14954,0.557744566467392,8,128202
8,173177834,SYN11401,173251700,SYN11404,0.4575197673913,3,73866
8,173554041,PZB01872.2,173565193,ZM003074-0422,0.287878786666667,3,11152
8,173714715,SYNGENTA14235,173800087,SYN10419,0.77341238623188,6,85372
8,173975164,SYN22252,173977740,PZE-108134421,0.762327072826085,2,2576
8,174422756,SYN20802,174423395,SYN20800,0.54333497978261,2,639
8,174953437,PZE-108135393,175733619,PZE-108135936,0.34357378548309,18,780182
9,565565,PZE-109000143,572218,PZE-109000122,0.797519764891305,4,6653
9,1306502,PZE-109000682,1873703,PZE-109001327,0.424633066434783,15,567201
9,5004211,PZE-109004430,5005900,PZE-109004462,0.82986166326087,2,1689
9,6491517,PZE-109005879,6779616,ZM011159-0722,0.41519762391304,3,288099
9,7580364,PZE-109006644,7621027,SYNGENTA6092,0.42844120326087,4,40663
9,7958802,SYN39069,7960037,SYN39067,0.82671936304348,4,1235
9,8136775,PZE-109007391,8415633,SYN13449,0.815506423152177,4,278858
9,8741151,PZE-109008133,8954555,SYN20003,2.47312055008696,10,213404
9,10008327,PZE-109009220,10012176,SYN38471,0.50399950706522,4,3849
9,11078532,PZE-109009936,11080686,PUT-163a-18163412-1252,0.280696643043475,2,2154
9,11217681,PZE-109010252,11233351,SYN31947,0.972223319855073,3,15670
9,11496522,SYNGENTA10406,11499195,sh1.11,0.20692687565217,2,2673
9,11711337,PUT-163a-6031569-2337,11714521,SYN33213,0.24797101449275,3,3184
9,11778827,PZE-109011385,12330275,PZE-109011647,2.31122009631579,19,551448
9,12621579,PZE-109011993,12983891,PZE-109012555,0.638248026260868,10,362312
9,13429438,PZE-109012939,13452442,PZE-109013008,1.66850131782609,6,23004
9,15700369,PZE-109015601,15905862,PZE-109015674,0.40995059652174,2,205493
9,15982995,PUT-163a-16926106-1129,16037869,PZE-109015843,0.45027668347826,9,54874
9,17750933,PHM9374.5,18620935,PZE-109018226,0.782710805507247,6,870002
9,19393702,PZA-003058021,19537694,PZE-109019272,0.27641304347826,6,143992
9,20310974,PZE-109019827,20311085,PZE-109019829,0.579476284130435,2,111
9,21967141,PZE-109021713,22056017,PZE-109021854,0.60371541956522,7,88876
9,22325198,SYN31842,22328728,PZE-109022096,1.01553359623188,3,3530
9,23056194,PZE-109022590,23061727,PZE-109022638,0.556693016521737,3,5533
9,24333911,PZE-109024175,24464861,PZE-109024365,0.743241105507246,3,130950
9,26477793,PZE-109025969,26485782,PZE-109026003,0.287317194130435,2,7989
9,26606680,SYN34141,27179398,PZE-109027190,0.887177400818413,17,572718
9,30646914,PZE-109028615,30944694,PZE-109028793,0.424266301847825,4,297780
9,31698317,PZE-109029278,31909693,PZE-109029368,0.85736165826087,4,211376
9,32946981,PZE-109029553,42289811,PZE-109033621,1.38578420456187,130,9342830
9,47830068,SYN24168,51667312,PZE-109037353,0.534487903137485,74,3837244
9,66588888,PZE-109047293,66594350,PZE-109047315,0.453761526811593,3,5462
9,69495698,PZE-109039294,71638337,PZE-109038390,0.602915338401122,31,2142639
9,72523996,PZE-109038114,76090586,PZE-109044429,0.986106954596273,42,3566590
9,76263908,PZE-109044471,77408070,PZE-109045003,0.766512407028985,18,1144162
9,78164542,SYN34247,81213528,PZE-109046832,0.339142571180124,35,3048986
9,88181396,SYN38486,90009821,PZE-109051663,1.60137928126812,36,1828425
9,90215180,PZE-109051855,90992680,PZE-109052393,0.42461462086957,22,777500
9,93280586,PZE-109053707,93676424,PZE-109053921,0.609104083260865,12,395838
9,93990693,PZE-109054051,96073942,PZE-109054943,0.455264919316772,42,2083249
9,99298355,PZE-109057545,99639494,SYN22533,1.22284432685619,13,341139
9,99909644,PZE-109058064,101356895,PZE-109059124,1.07771101762973,31,1447251
9,102304350,PZE-109060083,102518991,PZE-109060220,0.563962449813664,7,214641
9,105606078,PZE-109062535,105667576,PZE-109062557,0.532692689565215,2,61498
9,106037397,PZE-109063133,107840288,SYN35518,0.8774545465,20,1802891
9,108708874,PZE-109065881,109035201,PZE-109065941,0.557611167826085,4,326327
9,110459225,PZE-109067146,110459334,PZE-109067144,0.76834979782609,2,109
9,111981120,PZE-109068128,112002890,PZE-109068152,0.533179345326087,4,21770
9,113062409,PZE-109068897,113214386,SYN29693,0.67534585434783,2,151977
9,115762938,PZE-109070904,116272960,PZE-109071550,0.843514492753623,9,510022
9,117044750,PZE-109072385,117051754,PZE-109072454,0.901828063695655,2,7004
9,120625321,PZE-109074671,121602328,SYN4637,0.895909088,20,977007
9,124767255,PZE-109077330,124770857,PZE-109077339,0.292870556086955,2,3602
9,127426944,PZE-109079358,127650377,PZE-109079696,0.669736491449275,9,223433
9,128715601,PZE-109080799,128726984,PZE-109080751,0.29861165826087,2,11383
9,130494643,SYN3443,130884449,PZE-109082251,0.742340489627326,14,389806
9,131724860,PZE-109083049,132007657,PZE-109083328,0.450776241980676,9,282797
9,133546449,SYN35244,133586192,PZE-109084575,0.272968659565217,7,39743
9,133918835,PZE-109085244,134544459,PZE-109085791,1.03469235527536,15,625624
9,136040088,PZE-109087443,136084461,SYN27758,0.238422926173912,5,44373
9,136476503,SYNGENTA15117,136476528,SYNGENTA15104,0.42147233565217,2,25
9,136560055,ZM008455-0538,136583562,SYN38269,0.64698616782609,5,23507
9,136914159,PZE-109088740,136925519,PZE-109088808,0.365382077898553,6,11360
9,137413358,PUT-163a-94480077-4901,137413641,PUT-163a-94480077-4903,1.62512845804348,2,283
9,137784138,PZE-109089873,138312159,SYN8886,1.32823891135266,9,528021
9,138886702,SYN4010,138977471,PZE-109091985,0.861967815962734,7,90769
9,139409904,SYN27196,139748775,PZB01436.1,0.301242233167701,7,338871
9,139959937,PZE-109093487,140154092,PZE-109093862,0.409187745217388,10,194155
9,141469803,SYN11597,141476998,SYN11601,1.23607707782609,6,7195
9,141828445,PZE-109096003,141842203,SYN26727,0.33609091,5,13758
9,142472548,SYN22633,142495938,SYN23501,0.22462450956522,2,23390
9,142945372,SYN30951,142957174,PZE-109097755,0.928396741630435,4,11802
9,143052430,PZE-109097849,143165791,PZE-109098119,0.379021739130433,3,113361
9,143897835,SYN27711,143962186,PZE-109099090,0.791818180000002,4,64351
9,144504896,ZM013717-0297,144800224,SYN22241,0.686444100807453,7,295328
9,144882817,ZM008459-0215,145041919,PUT-163a-148938321-429,0.58106718913043,3,159102
9,146872696,PZE-109103538,146872957,PZA02197.1,0.222529642753627,3,261
9,147290584,PZE-109103952,147511324,PZE-109104633,1.544704545,20,220740
9,147615577,PZE-109104793,147616696,PZE-109104798,0.30176877652174,2,1119
9,147959320,PZE-109105874,147968682,PZE-109105942,0.326195652173915,2,9362
9,148051161,PZE-109106186,148447982,PZE-109106665,0.4113438726087,13,396821
9,149119731,PZE-109107497,149169318,PZE-109107539,0.558554020869569,6,49587
9,149444409,PZE-109108074,149457958,PZE-109108323,0.640754283768117,3,13549
9,149971537,PZE-109109300,149991030,PZE-109109342,0.662883401391306,5,19493
9,150644606,PZE-109109841,150715717,PZE-109109928,0.58074110217391,4,71111
9,150819848,PZE-109110011,150981851,PZE-109110504,0.557995167971015,9,162003
9,151285530,SYN7106,151481015,PZE-109112279,0.369787839769819,17,195485
9,151993440,PZE-109113950,152049003,PZE-109113974,0.24460474217391,5,55563
9,152494067,PZE-109115209,152647711,SYN8365,0.36347826086957,9,153644
9,153694093,SYN15948,153750609,SYN15966,2.78339097405797,6,56516
9,153847804,SYN13929,153885125,SYN13932,0.689614620869565,6,37321
9,154088892,SYN13953,154089025,SYN13951,0.41618577347826,2,133
9,154565566,SYN6658,154605135,SYN23705,0.95685770478261,6,39569
10,1283004,PZE-110000313,1285447,PZE-110000347,0.316847826086955,2,2443
10,2434554,SYN17621,2446890,PZE-110002415,0.28519762391304,7,12336
10,2799564,PUT-163a-148991534-709,2799884,PUT-163a-148991534-705,0.923218048550723,3,320
10,4649550,SYN4482,4666375,PZE-110005408,0.545071640543477,4,16825
10,5725146,PZE-110007514,5749490,SYN17097,0.520975436956523,7,24344
10,8276909,PZE-110009869,8355158,PZE-110009907,0.973330040434785,2,78249
10,8705031,PZE-110010024,8790330,PUT-163a-71434660-3308,2.07705830030435,10,85299
10,10606397,PZE-110012098,10825299,PZE-110012360,0.667200736645962,7,218902
10,11195384,PZE-110012703,11195540,SYN4993,0.507915018550723,3,156
10,11722338,PZE-110013051,12102986,PZE-110013362,0.483011854434781,10,380648
10,14446603,PZE-110014871,14496228,PZE-110014882,0.359202077826085,4,49625
10,15396083,SYN19875,15800292,SYN37112,0.318164691594203,15,404209
10,19643499,PZE-110017624,21551571,SYN16539,2.88305782217391,31,1908072
10,23214551,PZE-110019199,24651934,PZE-110019728,1.01216680991848,32,1437383
10,25279249,PZE-110020065,25563165,PZE-110020166,0.8714962125,12,283916
10,25667710,PZE-110020248,27398104,PZE-110020779,0.575951153304343,35,1730394
10,61384666,PZE-110032692,65616957,PZE-110034501,1.74906844173317,73,4232291
10,66016445,PZE-110034738,66174772,PZE-110034840,0.354407111594203,3,158327
10,67933073,PZE-110035766,68727027,PZE-110036048,1.53056653521739,9,793954
10,68984904,PZE-110036140,69031285,PZA00665.6,0.262049407478261,5,46381
10,69587659,PZE-110036445,70293915,PZE-110036798,0.479026679192546,14,706256
10,70540488,PZE-110036951,70633663,PZE-110037004,1.01913043811594,3,93175
10,74889415,PZE-110038912,75579226,PZE-110039214,0.446366929565217,3,689811
10,76638537,SYN22037,76645374,SYN22043,0.550612649130435,6,6837
10,77258388,PZE-110040162,77556841,PZE-110040622,0.709296899732441,13,298453
10,78062025,PZE-110040848,78147707,PZE-110040983,0.629090907999998,5,85682
10,78373012,PZE-110041090,79273371,PZE-110041441,1.96051300894928,12,900359
10,80405995,PZE-110042144,81051543,PZE-110042577,0.277268570022883,19,645548
10,83594630,PZE-110043783,84019203,PZE-110044111,0.676730482826087,8,424573
10,84230657,PZE-110044324,85188524,SYN8176,0.25080039434783,16,957867
10,85582965,PZE-110045084,85840070,PZE-110045521,0.523812252782608,5,257105
10,86416656,SYN37479,87133996,SYN27344,0.38086956521739,18,717340
10,91358505,PZE-110048719,91929519,PZE-110049046,1.2133742116624,17,571014
10,92033667,PZE-110049179,92823460,PZE-110049408,1.19163492418972,11,789793
10,93277338,PZE-110049572,93399593,PZE-110049642,1.2234288548913,4,122255
10,94155639,PZE-110049863,94200010,PZE-110050012,0.984407118260869,3,44371
10,94698918,PZE-110050177,99108072,PZE-110052414,1.51365428610906,59,4409154
10,99746351,SYN15825,100028018,PZE-110053215,0.314339043913043,9,281667
10,101892272,PZE-110053754,105855168,PZE-110055163,1.87426046398221,44,3962896
10,106434346,PUT-163a-50323824-2171,108359988,PZE-110056279,1.31244002047523,43,1925642
10,113712257,SYN16793,113943489,PZE-110059855,0.637318179333335,15,231232
10,114114444,SYN35611,115440570,PZE-110060993,0.944691766493686,31,1326126
10,117855995,PZE-110062942,118836695,PZE-110063475,0.872740858831519,16,980700
10,121412033,PZE-110065551,122254800,SYN27051,0.72959486347826,32,842767
10,122256896,SYN27048,122272052,PZE-110066518,0.33363438826087,5,15156
10,123821658,PZE-110067273,124068190,SYN15050,0.27472331652174,7,246532
10,124326869,PZE-110067825,124335062,PZE-110067922,0.27340909,5,8193
10,126490323,SYN25419,126586927,PZE-110069626,0.371750110096618,9,96604
10,127247580,PZE-110070241,127261630,PZE-110070387,0.385076579891305,4,14050
10,127364420,PZE-110070679,127372035,PZE-110070863,0.508652834492753,3,7615
10,132175919,PZE-110076077,132182955,PZE-110076146,0.29502964275362,3,7036
10,132553618,SYN22956,132970062,PZE-110077699,0.877043174916389,13,416444
10,133273679,PZE-110078058,133367582,SYN37247,0.504839919130434,5,93903
10,133714022,PZE-110079148,133714104,PZE-110079152,0.37020256826087,2,82
10,134057772,PZE-110079791,134719287,PZE-110080741,2.58794832267311,27,661515
10,135911656,SYN18729,135912730,SYN18728,1.69472002528985,6,1074
10,136105175,PZE-110083653,136106175,PZE-110083667,0.328759878695655,2,1000
10,137282014,PZE-110085687,137290148,PZE-110085760,0.68805335695652,3,8134
10,137952519,SYN9254,138024585,SYNGENTA14996,0.796935520760871,16,72066
10,138212884,SYN21905,138345648,PZE-110087958,0.21094861478261,5,132764
10,140268347,PZE-110091181,140305449,PZE-110091103,0.913196643043475,2,37102
10,140982509,PZE-110092089,141078848,SYN4068,0.6204347826087,6,96339
10,141279981,PZE-110093258,141298245,PZE-110093311,0.223481553768117,3,18264
10,142034125,SYN9690,142281160,PZE-110095272,1.13392457251208,18,247035
10,142725799,SYN1018,142793836,SYN21829,0.22803853891304,2,68037
10,142920500,SYN39312,142928823,SYN39323,0.21165020217391,4,8323
10,143243713,PZE-110097371,143443359,PZE-110097736,0.439480083244146,13,199646
10,143740270,SYN22938,144061151,PZA-002969009,0.706584980782608,5,320881
10,144135332,PZE-110098754,144446323,SYN15700,0.289028025573121,11,310991
10,145620822,SYN11610,145894425,PZE-110102725,0.23645256826087,3,273603
10,146075877,SYN15271,146114945,SYNGENTA16137,0.903811405465838,7,39068
10,146294633,PZB01471.3,146294693,PZB01471.1,0.86966897369565,2,60
10,147118940,PZE-110105426,147137485,PZE-110105621,0.646795950434785,4,18545
10,147402365,PUT-163a-149100124-916,147404812,PZE-110106563,0.462010869565215,4,2447
10,147593194,PZE-110106915,147722179,SYN19920,0.493328392318838,12,128985
10,148503131,PZE-110109359,148515533,PZE-110109454,1.02063834173913,5,12402
10,148998873,SYN36514,150096952,PZE-110111440,0.91097269847826,16,1098079
